year,exp,type,tko_ok_thr_min,tko_ok_thr_mid,tko_ok_thr_max,tko_ok,tko_ko,tko
2015,ssp126,A20n,836490,309758,55184,1201432,83947,1285379
2015,ssp126,A359,82608,651529,233217,967354,318025,1285379
2015,ssp126,B39m,15952,492826,512329,1021107,264272,1285379
2015,ssp126,B789,24330,524644,266638,815612,469767,1285379
2015,ssp245,A20n,838854,307799,55085,1201738,83641,1285379
2015,ssp245,A359,83331,650786,234506,968623,316756,1285379
2015,ssp245,B39m,16092,492814,512779,1021685,263694,1285379
2015,ssp245,B789,24569,524176,269528,818273,467106,1285379
2015,ssp370,A20n,837628,308558,55363,1201549,83830,1285379
2015,ssp370,A359,82902,651382,234466,968750,316629,1285379
2015,ssp370,B39m,15857,492975,512914,1021746,263633,1285379
2015,ssp370,B789,24078,524948,268226,817252,468127,1285379
2015,ssp585,A20n,836608,309495,55204,1201307,84072,1285379
2015,ssp585,A359,82064,651515,234868,968447,316932,1285379
2015,ssp585,B39m,16233,492144,513426,1021803,263576,1285379
2015,ssp585,B789,24628,524219,267378,816225,469154,1285379
2016,ssp126,A20n,838798,311008,55187,1204993,84791,1289784
2016,ssp126,A359,82830,652494,235160,970484,319300,1289784
2016,ssp126,B39m,16372,493770,514813,1024955,264829,1289784
2016,ssp126,B789,24595,525713,267561,817869,471915,1289784
2016,ssp245,A20n,841578,308557,55134,1205269,84515,1289784
2016,ssp245,A359,83454,653405,234635,971494,318290,1289784
2016,ssp245,B39m,16089,495265,514531,1025885,263899,1289784
2016,ssp245,B789,24579,526809,269404,820792,468992,1289784
2016,ssp370,A20n,841019,309228,55457,1205704,84080,1289784
2016,ssp370,A359,83050,653965,234179,971194,318590,1289784
2016,ssp370,B39m,16141,493875,515929,1025945,263839,1289784
2016,ssp370,B789,24599,525757,269536,819892,469892,1289784
2016,ssp585,A20n,838723,311414,55028,1205165,84619,1289784
2016,ssp585,A359,81269,654970,234172,970411,319373,1289784
2016,ssp585,B39m,15671,494758,513978,1024407,265377,1289784
2016,ssp585,B789,23792,526655,266994,817441,472343,1289784
2017,ssp126,A20n,837106,310554,54532,1202192,84068,1286260
2017,ssp126,A359,80093,654967,231929,966989,319271,1286260
2017,ssp126,B39m,14994,494703,512303,1022000,264260,1286260
2017,ssp126,B789,23145,526042,266723,815910,470350,1286260
2017,ssp245,A20n,837631,309650,54787,1202068,84192,1286260
2017,ssp245,A359,81814,652528,233673,968015,318245,1286260
2017,ssp245,B39m,15520,494162,511905,1021587,264673,1286260
2017,ssp245,B789,23534,525645,267340,816519,469741,1286260
2017,ssp370,A20n,832632,313790,54931,1201353,84907,1286260
2017,ssp370,A359,76459,655681,232647,964787,321473,1286260
2017,ssp370,B39m,13619,493674,513080,1020373,265887,1286260
2017,ssp370,B789,21182,525363,264511,811056,475204,1286260
2017,ssp585,A20n,837105,310074,54676,1201855,84405,1286260
2017,ssp585,A359,80483,654114,234002,968599,317661,1286260
2017,ssp585,B39m,14817,494815,512745,1022377,263883,1286260
2017,ssp585,B789,22655,526274,266969,815898,470362,1286260
2018,ssp126,A20n,837643,309587,54310,1201540,84720,1286260
2018,ssp126,A359,80053,654606,232792,967451,318809,1286260
2018,ssp126,B39m,14672,494159,512575,1021406,264854,1286260
2018,ssp126,B789,22627,525945,267692,816264,469996,1286260
2018,ssp245,A20n,834373,312376,54872,1201621,84639,1286260
2018,ssp245,A359,78211,655530,232111,965852,320408,1286260
2018,ssp245,B39m,14221,494111,512719,1021051,265209,1286260
2018,ssp245,B789,21697,526371,265310,813378,472882,1286260
2018,ssp370,A20n,833838,313425,53812,1201075,85185,1286260
2018,ssp370,A359,77840,655569,231145,964554,321706,1286260
2018,ssp370,B39m,14268,493737,512614,1020619,265641,1286260
2018,ssp370,B789,21962,525253,265053,812268,473992,1286260
2018,ssp585,A20n,835236,311898,54946,1202080,84180,1286260
2018,ssp585,A359,78512,655617,232668,966797,319463,1286260
2018,ssp585,B39m,14010,494694,513259,1021963,264297,1286260
2018,ssp585,B789,21936,526316,265852,814104,472156,1286260
2019,ssp126,A20n,837472,310465,54259,1202196,84064,1286260
2019,ssp126,A359,80881,653863,233329,968073,318187,1286260
2019,ssp126,B39m,15559,493707,513355,1022621,263639,1286260
2019,ssp126,B789,23606,525283,267639,816528,469732,1286260
2019,ssp245,A20n,833780,312770,54477,1201027,85233,1286260
2019,ssp245,A359,77862,655075,231792,964729,321531,1286260
2019,ssp245,B39m,14653,493095,512845,1020593,265667,1286260
2019,ssp245,B789,22660,524518,265218,812396,473864,1286260
2019,ssp370,A20n,835172,311830,54592,1201594,84666,1286260
2019,ssp370,A359,81705,651111,231733,964549,321711,1286260
2019,ssp370,B39m,15652,491534,513373,1020559,265701,1286260
2019,ssp370,B789,23868,522974,266999,813841,472419,1286260
2019,ssp585,A20n,838058,309551,54467,1202076,84184,1286260
2019,ssp585,A359,81625,653282,232186,967093,319167,1286260
2019,ssp585,B39m,15170,494145,512596,1021911,264349,1286260
2019,ssp585,B789,23406,525012,268142,816560,469700,1286260
2020,ssp126,A20n,840442,309857,54932,1205231,84553,1289784
2020,ssp126,A359,81191,654867,234985,971043,318741,1289784
2020,ssp126,B39m,15333,495400,515008,1025741,264043,1289784
2020,ssp126,B789,23249,527134,268817,819200,470584,1289784
2020,ssp245,A20n,841318,309323,55167,1205808,83976,1289784
2020,ssp245,A359,83343,652553,234459,970355,319429,1289784
2020,ssp245,B39m,15679,493864,515500,1025043,264741,1289784
2020,ssp245,B789,24192,524959,271284,820435,469349,1289784
2020,ssp370,A20n,838965,311174,54972,1205111,84673,1289784
2020,ssp370,A359,81647,653889,234984,970520,319264,1289784
2020,ssp370,B39m,15660,494734,514517,1024911,264873,1289784
2020,ssp370,B789,24026,526295,267723,818044,471740,1289784
2020,ssp585,A20n,839573,310612,55036,1205221,84563,1289784
2020,ssp585,A359,81686,653911,234226,969823,319961,1289784
2020,ssp585,B39m,15841,493128,515454,1024423,265361,1289784
2020,ssp585,B789,24024,524839,269706,818569,471215,1289784
2021,ssp126,A20n,840514,307275,54617,1202406,83854,1286260
2021,ssp126,A359,81713,653490,233784,968987,317273,1286260
2021,ssp126,B39m,15480,493639,514100,1023219,263041,1286260
2021,ssp126,B789,23972,525092,270649,819713,466547,1286260
2021,ssp245,A20n,835632,311570,54657,1201859,84401,1286260
2021,ssp245,A359,78925,655029,233103,967057,319203,1286260
2021,ssp245,B39m,14582,493941,512557,1021080,265180,1286260
2021,ssp245,B789,22451,525310,266290,814051,472209,1286260
2021,ssp370,A20n,838091,308488,55450,1202029,84231,1286260
2021,ssp370,A359,83633,651020,233711,968364,317896,1286260
2021,ssp370,B39m,16574,492560,513367,1022501,263759,1286260
2021,ssp370,B789,24842,524394,268512,817748,468512,1286260
2021,ssp585,A20n,835936,311303,54851,1202090,84170,1286260
2021,ssp585,A359,78781,655804,232128,966713,319547,1286260
2021,ssp585,B39m,14602,494000,513228,1021830,264430,1286260
2021,ssp585,B789,22050,525992,266783,814825,471435,1286260
2022,ssp126,A20n,839541,307974,54869,1202384,83876,1286260
2022,ssp126,A359,84298,650696,232915,967909,318351,1286260
2022,ssp126,B39m,16313,493171,512878,1022362,263898,1286260
2022,ssp126,B789,24899,524280,269427,818606,467654,1286260
2022,ssp245,A20n,833922,312841,54665,1201428,84832,1286260
2022,ssp245,A359,79076,653661,232871,965608,320652,1286260
2022,ssp245,B39m,15167,492248,513120,1020535,265725,1286260
2022,ssp245,B789,23106,524260,265379,812745,473515,1286260
2022,ssp370,A20n,835924,311358,54845,1202127,84133,1286260
2022,ssp370,A359,82111,651805,233026,966942,319318,1286260
2022,ssp370,B39m,15340,493088,513786,1022214,264046,1286260
2022,ssp370,B789,23426,524679,266856,814961,471299,1286260
2022,ssp585,A20n,834738,313344,53804,1201886,84374,1286260
2022,ssp585,A359,78582,654647,233117,966346,319914,1286260
2022,ssp585,B39m,14407,492793,514483,1021683,264577,1286260
2022,ssp585,B789,22265,525096,265966,813327,472933,1286260
2023,ssp126,A20n,832529,314287,54848,1201664,84596,1286260
2023,ssp126,A359,77650,655453,231235,964338,321922,1286260
2023,ssp126,B39m,14164,492882,512799,1019845,266415,1286260
2023,ssp126,B789,21808,524925,264121,810854,475406,1286260
2023,ssp245,A20n,838220,309408,54541,1202169,84091,1286260
2023,ssp245,A359,81856,652595,233798,968249,318011,1286260
2023,ssp245,B39m,15376,494132,512863,1022371,263889,1286260
2023,ssp245,B789,23762,525875,267581,817218,469042,1286260
2023,ssp370,A20n,838098,309012,55058,1202168,84092,1286260
2023,ssp370,A359,83558,650330,234054,967942,318318,1286260
2023,ssp370,B39m,16474,492334,513183,1021991,264269,1286260
2023,ssp370,B789,25002,522988,269403,817393,468867,1286260
2023,ssp585,A20n,836191,311357,54155,1201703,84557,1286260
2023,ssp585,A359,80971,652840,232955,966766,319494,1286260
2023,ssp585,B39m,15003,494072,512620,1021695,264565,1286260
2023,ssp585,B789,22850,525723,266213,814786,471474,1286260
2024,ssp126,A20n,836693,314279,54110,1205082,84702,1289784
2024,ssp126,A359,79062,656227,232227,967516,322268,1289784
2024,ssp126,B39m,14735,493899,515676,1024310,265474,1289784
2024,ssp126,B789,22626,526014,266744,815384,474400,1289784
2024,ssp245,A20n,837949,312829,54763,1205541,84243,1289784
2024,ssp245,A359,79876,655906,232997,968779,321005,1289784
2024,ssp245,B39m,14936,494473,515627,1025036,264748,1289784
2024,ssp245,B789,23080,526308,267402,816790,472994,1289784
2024,ssp370,A20n,839299,310983,55388,1205670,84114,1289784
2024,ssp370,A359,81160,654800,235031,970991,318793,1289784
2024,ssp370,B39m,15133,495679,514542,1025354,264430,1289784
2024,ssp370,B789,23077,527383,267856,818316,471468,1289784
2024,ssp585,A20n,840166,309660,55396,1205222,84562,1289784
2024,ssp585,A359,82616,653525,234221,970362,319422,1289784
2024,ssp585,B39m,15895,494028,514904,1024827,264957,1289784
2024,ssp585,B789,24158,526045,269018,819221,470563,1289784
2025,ssp126,A20n,834855,311862,55197,1201914,84346,1286260
2025,ssp126,A359,81218,651760,233276,966254,320006,1286260
2025,ssp126,B39m,15679,491998,513392,1021069,265191,1286260
2025,ssp126,B789,23521,524151,266554,814226,472034,1286260
2025,ssp245,A20n,837226,309901,55037,1202164,84096,1286260
2025,ssp245,A359,82521,650840,232588,965949,320311,1286260
2025,ssp245,B39m,16150,491173,513975,1021298,264962,1286260
2025,ssp245,B789,24447,522673,268949,816069,470191,1286260
2025,ssp370,A20n,836932,310886,54697,1202515,83745,1286260
2025,ssp370,A359,80537,654179,232485,967201,319059,1286260
2025,ssp370,B39m,15387,492579,513865,1021831,264429,1286260
2025,ssp370,B789,23557,524476,267794,815827,470433,1286260
2025,ssp585,A20n,836357,310254,54788,1201399,84861,1286260
2025,ssp585,A359,82332,650897,233571,966800,319460,1286260
2025,ssp585,B39m,15717,493199,512755,1021671,264589,1286260
2025,ssp585,B789,23791,524618,266938,815347,470913,1286260
2026,ssp126,A20n,835613,311151,54943,1201707,84553,1286260
2026,ssp126,A359,81743,652309,233407,967459,318801,1286260
2026,ssp126,B39m,15501,493152,512735,1021388,264872,1286260
2026,ssp126,B789,23679,525250,265996,814925,471335,1286260
2026,ssp245,A20n,835946,310634,55283,1201863,84397,1286260
2026,ssp245,A359,82373,651115,234526,968014,318246,1286260
2026,ssp245,B39m,16130,492196,512742,1021068,265192,1286260
2026,ssp245,B789,24088,525146,265780,815014,471246,1286260
2026,ssp370,A20n,835663,310850,54701,1201214,85046,1286260
2026,ssp370,A359,81825,651619,232057,965501,320759,1286260
2026,ssp370,B39m,15421,493124,511705,1020250,266010,1286260
2026,ssp370,B789,23914,523839,267057,814810,471450,1286260
2026,ssp585,A20n,837664,309098,54571,1201333,84927,1286260
2026,ssp585,A359,80859,652782,233120,966761,319499,1286260
2026,ssp585,B39m,14994,494239,512453,1021686,264574,1286260
2026,ssp585,B789,22936,526149,267642,816727,469533,1286260
2027,ssp126,A20n,835880,311251,54223,1201354,84906,1286260
2027,ssp126,A359,78495,655337,232221,966053,320207,1286260
2027,ssp126,B39m,14090,493633,513396,1021119,265141,1286260
2027,ssp126,B789,21597,526213,266850,814660,471600,1286260
2027,ssp245,A20n,836857,309546,55620,1202023,84237,1286260
2027,ssp245,A359,83589,649932,234071,967592,318668,1286260
2027,ssp245,B39m,16590,491822,513354,1021766,264494,1286260
2027,ssp245,B789,25146,523767,267536,816449,469811,1286260
2027,ssp370,A20n,836055,310755,54629,1201439,84821,1286260
2027,ssp370,A359,82189,650141,233100,965430,320830,1286260
2027,ssp370,B39m,16236,490523,514262,1021021,265239,1286260
2027,ssp370,B789,24411,522297,267761,814469,471791,1286260
2027,ssp585,A20n,838271,308776,55089,1202136,84124,1286260
2027,ssp585,A359,82260,651834,233060,967154,319106,1286260
2027,ssp585,B39m,15778,492961,512736,1021475,264785,1286260
2027,ssp585,B789,24059,524413,268957,817429,468831,1286260
2028,ssp126,A20n,837783,312688,54776,1205247,84537,1289784
2028,ssp126,A359,79500,656154,232859,968513,321271,1289784
2028,ssp126,B39m,14598,494667,514712,1023977,265807,1289784
2028,ssp126,B789,22570,526776,267118,816464,473320,1289784
2028,ssp245,A20n,838784,311509,54918,1205211,84573,1289784
2028,ssp245,A359,82528,652878,233736,969142,320642,1289784
2028,ssp245,B39m,16233,493393,515157,1024783,265001,1289784
2028,ssp245,B789,24638,524753,268332,817723,472061,1289784
2028,ssp370,A20n,839901,310288,55071,1205260,84524,1289784
2028,ssp370,A359,82236,653615,234326,970177,319607,1289784
2028,ssp370,B39m,15665,493901,515416,1024982,264802,1289784
2028,ssp370,B789,24010,525704,269002,818716,471068,1289784
2028,ssp585,A20n,839238,311781,54285,1205304,84480,1289784
2028,ssp585,A359,80772,655589,233859,970220,319564,1289784
2028,ssp585,B39m,14893,495495,514466,1024854,264930,1289784
2028,ssp585,B789,22767,527493,267910,818170,471614,1289784
2029,ssp126,A20n,836868,310599,54877,1202344,83916,1286260
2029,ssp126,A359,80921,652080,233364,966365,319895,1286260
2029,ssp126,B39m,15262,491805,513468,1020535,265725,1286260
2029,ssp126,B789,23397,523060,268791,815248,471012,1286260
2029,ssp245,A20n,832029,315052,54455,1201536,84724,1286260
2029,ssp245,A359,78631,653128,232912,964671,321589,1286260
2029,ssp245,B39m,14232,492116,514068,1020416,265844,1286260
2029,ssp245,B789,21969,523580,265138,810687,475573,1286260
2029,ssp370,A20n,836825,309535,55358,1201718,84542,1286260
2029,ssp370,A359,80238,653652,232291,966181,320079,1286260
2029,ssp370,B39m,14711,492563,513946,1021220,265040,1286260
2029,ssp370,B789,22828,524514,268062,815404,470856,1286260
2029,ssp585,A20n,837484,309771,54467,1201722,84538,1286260
2029,ssp585,A359,79359,654795,232244,966398,319862,1286260
2029,ssp585,B39m,14472,493881,513038,1021391,264869,1286260
2029,ssp585,B789,22491,525682,267709,815882,470378,1286260
2030,ssp126,A20n,837844,309031,55007,1201882,84378,1286260
2030,ssp126,A359,84169,649506,234276,967951,318309,1286260
2030,ssp126,B39m,17044,491179,514081,1022304,263956,1286260
2030,ssp126,B789,25684,523265,267936,816885,469375,1286260
2030,ssp245,A20n,834483,312647,54204,1201334,84926,1286260
2030,ssp245,A359,79187,654065,233007,966259,320001,1286260
2030,ssp245,B39m,15017,492443,513663,1021123,265137,1286260
2030,ssp245,B789,22948,524437,265837,813222,473038,1286260
2030,ssp370,A20n,836760,310681,54304,1201745,84515,1286260
2030,ssp370,A359,80014,654341,231910,966265,319995,1286260
2030,ssp370,B39m,14717,493562,513390,1021669,264591,1286260
2030,ssp370,B789,22773,526208,266839,815820,470440,1286260
2030,ssp585,A20n,834328,313082,54586,1201996,84264,1286260
2030,ssp585,A359,77550,655042,231927,964519,321741,1286260
2030,ssp585,B39m,14235,492753,513705,1020693,265567,1286260
2030,ssp585,B789,22241,523871,266767,812879,473381,1286260
2031,ssp126,A20n,837073,310865,54389,1202327,83933,1286260
2031,ssp126,A359,80251,653676,234704,968631,317629,1286260
2031,ssp126,B39m,15230,493474,514063,1022767,263493,1286260
2031,ssp126,B789,23204,525340,267525,816069,470191,1286260
2031,ssp245,A20n,835163,311921,54532,1201616,84644,1286260
2031,ssp245,A359,81207,652680,232527,966414,319846,1286260
2031,ssp245,B39m,15587,493129,512922,1021638,264622,1286260
2031,ssp245,B789,23653,525027,265247,813927,472333,1286260
2031,ssp370,A20n,834351,312228,54645,1201224,85036,1286260
2031,ssp370,A359,80633,651944,232867,965444,320816,1286260
2031,ssp370,B39m,15309,492272,512966,1020547,265713,1286260
2031,ssp370,B789,23084,524582,265238,812904,473356,1286260
2031,ssp585,A20n,837100,308824,55575,1201499,84761,1286260
2031,ssp585,A359,83294,649253,232304,964851,321409,1286260
2031,ssp585,B39m,16330,490701,513999,1021030,265230,1286260
2031,ssp585,B789,24732,521985,269064,815781,470479,1286260
2032,ssp126,A20n,837744,312163,54668,1204575,85209,1289784
2032,ssp126,A359,80729,654356,232795,967880,321904,1289784
2032,ssp126,B39m,15524,493019,514866,1023409,266375,1289784
2032,ssp126,B789,23552,524760,268078,816390,473394,1289784
2032,ssp245,A20n,836781,313165,55409,1205355,84429,1289784
2032,ssp245,A359,80953,653899,234255,969107,320677,1289784
2032,ssp245,B39m,15536,494131,514872,1024539,265245,1289784
2032,ssp245,B789,23676,525583,266620,815879,473905,1289784
2032,ssp370,A20n,839086,311684,54618,1205388,84396,1289784
2032,ssp370,A359,80934,654970,234761,970665,319119,1289784
2032,ssp370,B39m,15254,494628,515546,1025428,264356,1289784
2032,ssp370,B789,23247,526447,267838,817532,472252,1289784
2032,ssp585,A20n,837815,311934,54826,1204575,85209,1289784
2032,ssp585,A359,81056,654728,232696,968480,321304,1289784
2032,ssp585,B39m,15711,493777,513944,1023432,266352,1289784
2032,ssp585,B789,24154,525420,267464,817038,472746,1289784
2033,ssp126,A20n,836263,310734,54637,1201634,84626,1286260
2033,ssp126,A359,79675,654517,232776,966968,319292,1286260
2033,ssp126,B39m,14920,493480,513723,1022123,264137,1286260
2033,ssp126,B789,22715,525421,267202,815338,470922,1286260
2033,ssp245,A20n,833954,312407,54886,1201247,85013,1286260
2033,ssp245,A359,78784,653510,232769,965063,321197,1286260
2033,ssp245,B39m,14628,492566,513619,1020813,265447,1286260
2033,ssp245,B789,22652,524377,265923,812952,473308,1286260
2033,ssp370,A20n,831328,315790,54113,1201231,85029,1286260
2033,ssp370,A359,75613,656123,232206,963942,322318,1286260
2033,ssp370,B39m,13768,492252,513550,1019570,266690,1286260
2033,ssp370,B789,21167,524674,263695,809536,476724,1286260
2033,ssp585,A20n,837315,309216,55608,1202139,84121,1286260
2033,ssp585,A359,79178,655196,232006,966380,319880,1286260
2033,ssp585,B39m,14939,493372,512648,1020959,265301,1286260
2033,ssp585,B789,22882,526061,267301,816244,470016,1286260
2034,ssp126,A20n,838035,310180,54046,1202261,83999,1286260
2034,ssp126,A359,81089,652760,233269,967118,319142,1286260
2034,ssp126,B39m,15211,492979,513611,1021801,264459,1286260
2034,ssp126,B789,23170,524870,268241,816281,469979,1286260
2034,ssp245,A20n,834943,312660,54456,1202059,84201,1286260
2034,ssp245,A359,78744,653680,232910,965334,320926,1286260
2034,ssp245,B39m,14722,491486,515010,1021218,265042,1286260
2034,ssp245,B789,22612,523995,266768,813375,472885,1286260
2034,ssp370,A20n,836058,311409,54632,1202099,84161,1286260
2034,ssp370,A359,79839,653438,232801,966078,320182,1286260
2034,ssp370,B39m,15316,492192,514110,1021618,264642,1286260
2034,ssp370,B789,23052,524466,267135,814653,471607,1286260
2034,ssp585,A20n,834943,311733,55102,1201778,84482,1286260
2034,ssp585,A359,77700,655559,232492,965751,320509,1286260
2034,ssp585,B39m,14251,494564,512278,1021093,265167,1286260
2034,ssp585,B789,21986,526097,265381,813464,472796,1286260
2035,ssp126,A20n,837141,309687,55063,1201891,84369,1286260
2035,ssp126,A359,82092,651234,233293,966619,319641,1286260
2035,ssp126,B39m,15725,491647,513948,1021320,264940,1286260
2035,ssp126,B789,23937,524026,268064,816027,470233,1286260
2035,ssp245,A20n,835036,311229,55053,1201318,84942,1286260
2035,ssp245,A359,80333,652588,232569,965490,320770,1286260
2035,ssp245,B39m,15966,491589,511836,1019391,266869,1286260
2035,ssp245,B789,23920,523394,266443,813757,472503,1286260
2035,ssp370,A20n,834683,311624,54869,1201176,85084,1286260
2035,ssp370,A359,79223,653996,231570,964789,321471,1286260
2035,ssp370,B39m,14569,492433,514065,1021067,265193,1286260
2035,ssp370,B789,22659,524562,266265,813486,472774,1286260
2035,ssp585,A20n,831944,315000,54585,1201529,84731,1286260
2035,ssp585,A359,78204,654172,231763,964139,322121,1286260
2035,ssp585,B39m,14520,492602,513146,1020268,265992,1286260
2035,ssp585,B789,22307,524524,263895,810726,475534,1286260
2036,ssp126,A20n,837375,312595,55192,1205162,84622,1289784
2036,ssp126,A359,82758,651343,235130,969231,320553,1289784
2036,ssp126,B39m,16134,492924,514309,1023367,266417,1289784
2036,ssp126,B789,24567,525678,266011,816256,473528,1289784
2036,ssp245,A20n,839826,310207,55048,1205081,84703,1289784
2036,ssp245,A359,83667,652342,234069,970078,319706,1289784
2036,ssp245,B39m,16551,492781,516018,1025350,264434,1289784
2036,ssp245,B789,25248,524160,269581,818989,470795,1289784
2036,ssp370,A20n,838615,312047,54229,1204891,84893,1289784
2036,ssp370,A359,79847,655928,233042,968817,320967,1289784
2036,ssp370,B39m,15448,494130,514103,1023681,266103,1289784
2036,ssp370,B789,23459,525720,267766,816945,472839,1289784
2036,ssp585,A20n,838420,311611,55137,1205168,84616,1289784
2036,ssp585,A359,81226,655395,232113,968734,321050,1289784
2036,ssp585,B39m,15168,494840,514154,1024162,265622,1289784
2036,ssp585,B789,23233,526573,267510,817316,472468,1289784
2037,ssp126,A20n,836682,310005,54789,1201476,84784,1286260
2037,ssp126,A359,83687,650082,232985,966754,319506,1286260
2037,ssp126,B39m,16428,492175,513314,1021917,264343,1286260
2037,ssp126,B789,25066,523794,267052,815912,470348,1286260
2037,ssp245,A20n,834998,312116,54191,1201305,84955,1286260
2037,ssp245,A359,79649,652933,232772,965354,320906,1286260
2037,ssp245,B39m,14862,492584,513698,1021144,265116,1286260
2037,ssp245,B789,22827,524890,266118,813835,472425,1286260
2037,ssp370,A20n,836372,310713,54640,1201725,84535,1286260
2037,ssp370,A359,79016,655065,231857,965938,320322,1286260
2037,ssp370,B39m,14705,493175,513210,1021090,265170,1286260
2037,ssp370,B789,22246,525971,266806,815023,471237,1286260
2037,ssp585,A20n,836308,310501,54836,1201645,84615,1286260
2037,ssp585,A359,78500,655370,232440,966310,319950,1286260
2037,ssp585,B39m,14702,494213,512427,1021342,264918,1286260
2037,ssp585,B789,22621,525691,267062,815374,470886,1286260
2038,ssp126,A20n,832847,313804,55013,1201664,84596,1286260
2038,ssp126,A359,78402,654254,232413,965069,321191,1286260
2038,ssp126,B39m,14788,492445,513133,1020366,265894,1286260
2038,ssp126,B789,22512,525121,264147,811780,474480,1286260
2038,ssp245,A20n,835733,311399,54938,1202070,84190,1286260
2038,ssp245,A359,79893,652797,233920,966610,319650,1286260
2038,ssp245,B39m,15107,492895,513080,1021082,265178,1286260
2038,ssp245,B789,23054,524763,267090,814907,471353,1286260
2038,ssp370,A20n,836454,310552,54908,1201914,84346,1286260
2038,ssp370,A359,78989,654892,232409,966290,319970,1286260
2038,ssp370,B39m,14085,494191,513337,1021613,264647,1286260
2038,ssp370,B789,22169,526534,266586,815289,470971,1286260
2038,ssp585,A20n,832610,313368,55180,1201158,85102,1286260
2038,ssp585,A359,78476,653781,230950,963207,323053,1286260
2038,ssp585,B39m,14785,491604,512766,1019155,267105,1286260
2038,ssp585,B789,22873,523122,265106,811101,475159,1286260
2039,ssp126,A20n,835547,311078,54989,1201614,84646,1286260
2039,ssp126,A359,80830,652264,232138,965232,321028,1286260
2039,ssp126,B39m,15894,491164,513638,1020696,265564,1286260
2039,ssp126,B789,23976,523167,267246,814389,471871,1286260
2039,ssp245,A20n,834045,311800,55370,1201215,85045,1286260
2039,ssp245,A359,79272,653399,231957,964628,321632,1286260
2039,ssp245,B39m,14508,493115,512366,1019989,266271,1286260
2039,ssp245,B789,22513,524824,265134,812471,473789,1286260
2039,ssp370,A20n,833815,313334,54652,1201801,84459,1286260
2039,ssp370,A359,80234,651779,233504,965517,320743,1286260
2039,ssp370,B39m,14860,492104,514420,1021384,264876,1286260
2039,ssp370,B789,22806,523459,266333,812598,473662,1286260
2039,ssp585,A20n,838100,308814,54909,1201823,84437,1286260
2039,ssp585,A359,82251,651438,232739,966428,319832,1286260
2039,ssp585,B39m,15830,492292,513700,1021822,264438,1286260
2039,ssp585,B789,24336,524112,268793,817241,469019,1286260
2040,ssp126,A20n,834039,316088,54456,1204583,85201,1289784
2040,ssp126,A359,80431,653048,233639,967118,322666,1289784
2040,ssp126,B39m,15246,493279,514908,1023433,266351,1289784
2040,ssp126,B789,23412,524825,264173,812410,477374,1289784
2040,ssp245,A20n,838879,311515,54945,1205339,84445,1289784
2040,ssp245,A359,81491,654086,233934,969511,320273,1289784
2040,ssp245,B39m,15505,493279,516284,1025068,264716,1289784
2040,ssp245,B789,23985,524069,269233,817287,472497,1289784
2040,ssp370,A20n,833951,315876,54814,1204641,85143,1289784
2040,ssp370,A359,78800,654723,232320,965843,323941,1289784
2040,ssp370,B39m,15018,492193,515017,1022228,267556,1289784
2040,ssp370,B789,22848,524470,265245,812563,477221,1289784
2040,ssp585,A20n,838019,311304,55060,1204383,85401,1289784
2040,ssp585,A359,79288,655947,232908,968143,321641,1289784
2040,ssp585,B39m,14853,494491,513891,1023235,266549,1289784
2040,ssp585,B789,22838,526214,267489,816541,473243,1289784
2041,ssp126,A20n,833485,313512,54388,1201385,84875,1286260
2041,ssp126,A359,78581,653918,232466,964965,321295,1286260
2041,ssp126,B39m,14245,492564,513608,1020417,265843,1286260
2041,ssp126,B789,22030,524615,265408,812053,474207,1286260
2041,ssp245,A20n,836975,310490,54948,1202413,83847,1286260
2041,ssp245,A359,81865,651625,233260,966750,319510,1286260
2041,ssp245,B39m,15650,492335,513753,1021738,264522,1286260
2041,ssp245,B789,23977,524262,267531,815770,470490,1286260
2041,ssp370,A20n,837323,309682,55309,1202314,83946,1286260
2041,ssp370,A359,79657,653470,233959,967086,319174,1286260
2041,ssp370,B39m,15162,493108,513108,1021378,264882,1286260
2041,ssp370,B789,23109,524675,268179,815963,470297,1286260
2041,ssp585,A20n,832510,313849,54866,1201225,85035,1286260
2041,ssp585,A359,76699,655843,232249,964791,321469,1286260
2041,ssp585,B39m,14181,493126,513122,1020429,265831,1286260
2041,ssp585,B789,21860,525547,263320,810727,475533,1286260
2042,ssp126,A20n,836271,310286,54830,1201387,84873,1286260
2042,ssp126,A359,80971,652531,233123,966625,319635,1286260
2042,ssp126,B39m,15502,492426,512908,1020836,265424,1286260
2042,ssp126,B789,23705,524362,266770,814837,471423,1286260
2042,ssp245,A20n,836503,309711,55237,1201451,84809,1286260
2042,ssp245,A359,82482,650781,232880,966143,320117,1286260
2042,ssp245,B39m,16061,491155,514309,1021525,264735,1286260
2042,ssp245,B789,24124,523193,268040,815357,470903,1286260
2042,ssp370,A20n,833651,312693,55272,1201616,84644,1286260
2042,ssp370,A359,78534,654080,232486,965100,321160,1286260
2042,ssp370,B39m,14712,492329,513423,1020464,265796,1286260
2042,ssp370,B789,22343,524998,264922,812263,473997,1286260
2042,ssp585,A20n,833796,312824,54935,1201555,84705,1286260
2042,ssp585,A359,76684,656487,230684,963855,322405,1286260
2042,ssp585,B39m,13809,493821,511836,1019466,266794,1286260
2042,ssp585,B789,21290,525806,265052,812148,474112,1286260
2043,ssp126,A20n,835902,311085,54565,1201552,84708,1286260
2043,ssp126,A359,79608,653755,233175,966538,319722,1286260
2043,ssp126,B39m,15195,492714,513542,1021451,264809,1286260
2043,ssp126,B789,23212,524977,266655,814844,471416,1286260
2043,ssp245,A20n,835601,310981,54886,1201468,84792,1286260
2043,ssp245,A359,81962,651327,233008,966297,319963,1286260
2043,ssp245,B39m,15866,492360,513230,1021456,264804,1286260
2043,ssp245,B789,24101,524500,266370,814971,471289,1286260
2043,ssp370,A20n,835576,310834,55020,1201430,84830,1286260
2043,ssp370,A359,78406,654279,231746,964431,321829,1286260
2043,ssp370,B39m,14414,492678,512993,1020085,266175,1286260
2043,ssp370,B789,22274,524525,267562,814361,471899,1286260
2043,ssp585,A20n,835495,311033,54762,1201290,84970,1286260
2043,ssp585,A359,78525,654650,230807,963982,322278,1286260
2043,ssp585,B39m,14645,491866,513353,1019864,266396,1286260
2043,ssp585,B789,22406,523849,268102,814357,471903,1286260
2044,ssp126,A20n,837531,312056,55404,1204991,84793,1289784
2044,ssp126,A359,80202,655397,233395,968994,320790,1289784
2044,ssp126,B39m,15149,494314,514299,1023762,266022,1289784
2044,ssp126,B789,23305,526283,266737,816325,473459,1289784
2044,ssp245,A20n,838028,311825,55273,1205126,84658,1289784
2044,ssp245,A359,80159,655416,233177,968752,321032,1289784
2044,ssp245,B39m,15154,495047,512830,1023031,266753,1289784
2044,ssp245,B789,23026,527149,266807,816982,472802,1289784
2044,ssp370,A20n,838590,310897,55067,1204554,85230,1289784
2044,ssp370,A359,80207,655178,232675,968060,321724,1289784
2044,ssp370,B39m,15228,493234,514950,1023412,266372,1289784
2044,ssp370,B789,23180,525631,268207,817018,472766,1289784
2044,ssp585,A20n,835410,314170,54781,1204361,85423,1289784
2044,ssp585,A359,78851,655422,232235,966508,323276,1289784
2044,ssp585,B39m,14890,493465,514806,1023161,266623,1289784
2044,ssp585,B789,22495,525642,265943,814080,475704,1289784
2045,ssp126,A20n,834686,312024,54602,1201312,84948,1286260
2045,ssp126,A359,79619,653421,231987,965027,321233,1286260
2045,ssp126,B39m,15232,490975,515034,1021241,265019,1286260
2045,ssp126,B789,23119,523217,266993,813329,472931,1286260
2045,ssp245,A20n,836420,310906,54653,1201979,84281,1286260
2045,ssp245,A359,79522,654510,232689,966721,319539,1286260
2045,ssp245,B39m,14412,494087,512868,1021367,264893,1286260
2045,ssp245,B789,22413,525969,266880,815262,470998,1286260
2045,ssp370,A20n,836436,310450,54915,1201801,84459,1286260
2045,ssp370,A359,81388,652050,233392,966830,319430,1286260
2045,ssp370,B39m,15372,492811,513493,1021676,264584,1286260
2045,ssp370,B789,23451,524524,267261,815236,471024,1286260
2045,ssp585,A20n,834821,311511,54544,1200876,85384,1286260
2045,ssp585,A359,79196,654363,231031,964590,321670,1286260
2045,ssp585,B39m,14531,493331,512690,1020552,265708,1286260
2045,ssp585,B789,22677,525527,265643,813847,472413,1286260
2046,ssp126,A20n,831040,316004,54092,1201136,85124,1286260
2046,ssp126,A359,77949,653364,231368,962681,323579,1286260
2046,ssp126,B39m,14695,490991,514170,1019856,266404,1286260
2046,ssp126,B789,22414,523516,263686,809616,476644,1286260
2046,ssp245,A20n,832630,314428,54575,1201633,84627,1286260
2046,ssp245,A359,79199,653174,232944,965317,320943,1286260
2046,ssp245,B39m,15079,492000,513853,1020932,265328,1286260
2046,ssp245,B789,22835,524377,263974,811186,475074,1286260
2046,ssp370,A20n,832134,314467,54740,1201341,84919,1286260
2046,ssp370,A359,78265,653502,231856,963623,322637,1286260
2046,ssp370,B39m,14374,492462,513382,1020218,266042,1286260
2046,ssp370,B789,22151,524555,263681,810387,475873,1286260
2046,ssp585,A20n,836103,309865,55042,1201010,85250,1286260
2046,ssp585,A359,82806,649923,232628,965357,320903,1286260
2046,ssp585,B39m,16027,491315,512705,1020047,266213,1286260
2046,ssp585,B789,24314,523811,266975,815100,471160,1286260
2047,ssp126,A20n,836652,310739,54310,1201701,84559,1286260
2047,ssp126,A359,78844,654613,233530,966987,319273,1286260
2047,ssp126,B39m,14527,492315,514118,1020960,265300,1286260
2047,ssp126,B789,22269,525008,268227,815504,470756,1286260
2047,ssp245,A20n,833184,314129,54184,1201497,84763,1286260
2047,ssp245,A359,77966,654150,231413,963529,322731,1286260
2047,ssp245,B39m,14481,490708,514174,1019363,266897,1286260
2047,ssp245,B789,22233,523069,266259,811561,474699,1286260
2047,ssp370,A20n,833965,312867,54684,1201516,84744,1286260
2047,ssp370,A359,79326,652434,231958,963718,322542,1286260
2047,ssp370,B39m,15214,490698,513915,1019827,266433,1286260
2047,ssp370,B789,23114,523223,266068,812405,473855,1286260
2047,ssp585,A20n,832748,313393,55207,1201348,84912,1286260
2047,ssp585,A359,78512,653631,231905,964048,322212,1286260
2047,ssp585,B39m,14964,491757,512675,1019396,266864,1286260
2047,ssp585,B789,22841,524138,264320,811299,474961,1286260
2048,ssp126,A20n,838547,310683,55882,1205112,84672,1289784
2048,ssp126,A359,84288,650817,234120,969225,320559,1289784
2048,ssp126,B39m,16679,491985,515311,1023975,265809,1289784
2048,ssp126,B789,25401,524206,268370,817977,471807,1289784
2048,ssp245,A20n,838712,311950,54719,1205381,84403,1289784
2048,ssp245,A359,79334,656935,232453,968722,321062,1289784
2048,ssp245,B39m,14550,494638,515107,1024295,265489,1289784
2048,ssp245,B789,22342,526736,268241,817319,472465,1289784
2048,ssp370,A20n,839664,309838,55583,1205085,84699,1289784
2048,ssp370,A359,83362,651985,233537,968884,320900,1289784
2048,ssp370,B39m,16510,492692,514519,1023721,266063,1289784
2048,ssp370,B789,24934,524474,269272,818680,471104,1289784
2048,ssp585,A20n,834760,315096,55181,1205037,84747,1289784
2048,ssp585,A359,78027,655655,232346,966028,323756,1289784
2048,ssp585,B39m,14921,493006,514636,1022563,267221,1289784
2048,ssp585,B789,22602,525532,265049,813183,476601,1289784
2049,ssp126,A20n,834433,312080,54978,1201491,84769,1286260
2049,ssp126,A359,80964,651378,231955,964297,321963,1286260
2049,ssp126,B39m,15882,491638,512634,1020154,266106,1286260
2049,ssp126,B789,24109,523342,265901,813352,472908,1286260
2049,ssp245,A20n,835117,311902,54882,1201901,84359,1286260
2049,ssp245,A359,79824,653622,232568,966014,320246,1286260
2049,ssp245,B39m,15431,491704,513711,1020846,265414,1286260
2049,ssp245,B789,23651,523653,266722,814026,472234,1286260
2049,ssp370,A20n,832897,313375,55275,1201547,84713,1286260
2049,ssp370,A359,80421,652339,231667,964427,321833,1286260
2049,ssp370,B39m,15650,492055,512458,1020163,266097,1286260
2049,ssp370,B789,23811,524721,263286,811818,474442,1286260
2049,ssp585,A20n,828308,318072,54263,1200643,85617,1286260
2049,ssp585,A359,74917,655917,229185,960019,326241,1286260
2049,ssp585,B39m,13206,491520,513103,1017829,268431,1286260
2049,ssp585,B789,20658,523894,261851,806403,479857,1286260
2050,ssp126,A20n,837399,309979,54592,1201970,84290,1286260
2050,ssp126,A359,81515,652253,232545,966313,319947,1286260
2050,ssp126,B39m,15465,491644,514220,1021329,264931,1286260
2050,ssp126,B789,23583,523260,269303,816146,470114,1286260
2050,ssp245,A20n,835511,311452,54878,1201841,84419,1286260
2050,ssp245,A359,78922,655000,232228,966150,320110,1286260
2050,ssp245,B39m,15038,493678,512679,1021395,264865,1286260
2050,ssp245,B789,23075,525116,266086,814277,471983,1286260
2050,ssp370,A20n,830122,316514,54638,1201274,84986,1286260
2050,ssp370,A359,75542,655961,230261,961764,324496,1286260
2050,ssp370,B39m,13755,492381,512706,1018842,267418,1286260
2050,ssp370,B789,21391,524784,261813,807988,478272,1286260
2050,ssp585,A20n,833412,313052,55092,1201556,84704,1286260
2050,ssp585,A359,79345,652333,231563,963241,323019,1286260
2050,ssp585,B39m,14619,491382,513447,1019448,266812,1286260
2050,ssp585,B789,22541,523618,265454,811613,474647,1286260
2051,ssp126,A20n,835131,311991,54767,1201889,84371,1286260
2051,ssp126,A359,80113,653236,233471,966820,319440,1286260
2051,ssp126,B39m,15271,492337,513935,1021543,264717,1286260
2051,ssp126,B789,22948,524533,266628,814109,472151,1286260
2051,ssp245,A20n,835746,310592,54937,1201275,84985,1286260
2051,ssp245,A359,80225,651702,231350,963277,322983,1286260
2051,ssp245,B39m,15511,490409,514443,1020363,265897,1286260
2051,ssp245,B789,23722,521971,268510,814203,472057,1286260
2051,ssp370,A20n,830495,315348,54878,1200721,85539,1286260
2051,ssp370,A359,75967,655495,229032,960494,325766,1286260
2051,ssp370,B39m,14393,490179,513486,1018058,268202,1286260
2051,ssp370,B789,21944,523305,263527,808776,477484,1286260
2051,ssp585,A20n,830701,315384,55054,1201139,85121,1286260
2051,ssp585,A359,78408,653324,231825,963557,322703,1286260
2051,ssp585,B39m,15191,490963,513664,1019818,266442,1286260
2051,ssp585,B789,22921,523821,262578,809320,476940,1286260
2052,ssp126,A20n,837283,312532,54981,1204796,84988,1289784
2052,ssp126,A359,80718,653898,233479,968095,321689,1289784
2052,ssp126,B39m,14887,493723,515558,1024168,265616,1289784
2052,ssp126,B789,22880,525965,267122,815967,473817,1289784
2052,ssp245,A20n,836284,314047,54734,1205065,84719,1289784
2052,ssp245,A359,79776,655569,232176,967521,322263,1289784
2052,ssp245,B39m,14760,493396,515150,1023306,266478,1289784
2052,ssp245,B789,22688,525271,266857,814816,474968,1289784
2052,ssp370,A20n,833597,315699,55093,1204389,85395,1289784
2052,ssp370,A359,78641,654652,231245,964538,325246,1289784
2052,ssp370,B39m,14670,492257,514525,1021452,268332,1289784
2052,ssp370,B789,22521,524875,264728,812124,477660,1289784
2052,ssp585,A20n,836257,313657,54932,1204846,84938,1289784
2052,ssp585,A359,78217,656943,231555,966715,323069,1289784
2052,ssp585,B39m,14951,493704,513627,1022282,267502,1289784
2052,ssp585,B789,22712,526999,265242,814953,474831,1289784
2053,ssp126,A20n,833990,313287,54798,1202075,84185,1286260
2053,ssp126,A359,79595,653104,232530,965229,321031,1286260
2053,ssp126,B39m,14499,491975,514175,1020649,265611,1286260
2053,ssp126,B789,22700,523603,266488,812791,473469,1286260
2053,ssp245,A20n,832177,314257,54712,1201146,85114,1286260
2053,ssp245,A359,76284,656567,231282,964133,322127,1286260
2053,ssp245,B39m,14142,493137,512910,1020189,266071,1286260
2053,ssp245,B789,21655,525679,263562,810896,475364,1286260
2053,ssp370,A20n,830413,316177,54325,1200915,85345,1286260
2053,ssp370,A359,76658,653840,231473,961971,324289,1286260
2053,ssp370,B39m,13928,489995,514327,1018250,268010,1286260
2053,ssp370,B789,21907,521977,265259,809143,477117,1286260
2053,ssp585,A20n,832923,313011,54920,1200854,85406,1286260
2053,ssp585,A359,77479,654831,230558,962868,323392,1286260
2053,ssp585,B39m,14365,491827,512990,1019182,267078,1286260
2053,ssp585,B789,22057,524518,264728,811303,474957,1286260
2054,ssp126,A20n,834034,312370,54641,1201045,85215,1286260
2054,ssp126,A359,78039,654910,231977,964926,321334,1286260
2054,ssp126,B39m,14334,492620,512993,1019947,266313,1286260
2054,ssp126,B789,22151,525193,265031,812375,473885,1286260
2054,ssp245,A20n,833324,313485,54754,1201563,84697,1286260
2054,ssp245,A359,79330,653134,231260,963724,322536,1286260
2054,ssp245,B39m,15208,490793,513112,1019113,267147,1286260
2054,ssp245,B789,22968,523700,265135,811803,474457,1286260
2054,ssp370,A20n,833577,312453,55217,1201247,85013,1286260
2054,ssp370,A359,79701,652156,230916,962773,323487,1286260
2054,ssp370,B39m,15134,491142,513182,1019458,266802,1286260
2054,ssp370,B789,22981,523692,265730,812403,473857,1286260
2054,ssp585,A20n,833813,312713,54866,1201392,84868,1286260
2054,ssp585,A359,77302,654500,230246,962048,324212,1286260
2054,ssp585,B39m,14319,491392,514048,1019759,266501,1286260
2054,ssp585,B789,22200,523590,266336,812126,474134,1286260
2055,ssp126,A20n,835773,310950,54923,1201646,84614,1286260
2055,ssp126,A359,79230,654234,230905,964369,321891,1286260
2055,ssp126,B39m,14632,493285,512715,1020632,265628,1286260
2055,ssp126,B789,22686,524343,267167,814196,472064,1286260
2055,ssp245,A20n,836056,310522,54707,1201285,84975,1286260
2055,ssp245,A359,81024,651900,231843,964767,321493,1286260
2055,ssp245,B39m,15238,491093,514140,1020471,265789,1286260
2055,ssp245,B789,23302,523579,268331,815212,471048,1286260
2055,ssp370,A20n,831324,315048,54596,1200968,85292,1286260
2055,ssp370,A359,76531,655092,231387,963010,323250,1286260
2055,ssp370,B39m,13664,491955,513712,1019331,266929,1286260
2055,ssp370,B789,21299,524508,263690,809497,476763,1286260
2055,ssp585,A20n,832697,313383,55055,1201135,85125,1286260
2055,ssp585,A359,77882,654379,230258,962519,323741,1286260
2055,ssp585,B39m,14217,492330,512266,1018813,267447,1286260
2055,ssp585,B789,22168,524285,264788,811241,475019,1286260
2056,ssp126,A20n,839413,310248,54702,1204363,85421,1289784
2056,ssp126,A359,81707,653800,232959,968466,321318,1289784
2056,ssp126,B39m,15368,493062,515228,1023658,266126,1289784
2056,ssp126,B789,23484,524808,269814,818106,471678,1289784
2056,ssp245,A20n,837317,312950,54911,1205178,84606,1289784
2056,ssp245,A359,79582,656148,232933,968663,321121,1289784
2056,ssp245,B39m,15120,494231,514326,1023677,266107,1289784
2056,ssp245,B789,23050,526654,266698,816402,473382,1289784
2056,ssp370,A20n,836421,313563,54785,1204769,85015,1289784
2056,ssp370,A359,78599,656704,231389,966692,323092,1289784
2056,ssp370,B39m,14853,492822,515020,1022695,267089,1289784
2056,ssp370,B789,22590,526308,266301,815199,474585,1289784
2056,ssp585,A20n,833083,316013,55108,1204204,85580,1289784
2056,ssp585,A359,75704,657786,231268,964758,325026,1289784
2056,ssp585,B39m,13410,493365,514274,1021049,268735,1289784
2056,ssp585,B789,20852,525987,264648,811487,478297,1289784
2057,ssp126,A20n,834774,311813,55209,1201796,84464,1286260
2057,ssp126,A359,80572,652650,232575,965797,320463,1286260
2057,ssp126,B39m,15534,492903,512337,1020774,265486,1286260
2057,ssp126,B789,23648,524667,265575,813890,472370,1286260
2057,ssp245,A20n,837170,309717,54582,1201469,84791,1286260
2057,ssp245,A359,79206,654704,232279,966189,320071,1286260
2057,ssp245,B39m,14901,493445,512152,1020498,265762,1286260
2057,ssp245,B789,22995,525493,267692,816180,470080,1286260
2057,ssp370,A20n,833855,312495,54800,1201150,85110,1286260
2057,ssp370,A359,78005,653775,231191,962971,323289,1286260
2057,ssp370,B39m,14598,491509,513040,1019147,267113,1286260
2057,ssp370,B789,22467,523972,265558,811997,474263,1286260
2057,ssp585,A20n,832019,313797,54824,1200640,85620,1286260
2057,ssp585,A359,76140,655522,229868,961530,324730,1286260
2057,ssp585,B39m,14104,492372,511771,1018247,268013,1286260
2057,ssp585,B789,21444,524806,264371,810621,475639,1286260
2058,ssp126,A20n,837727,308287,55671,1201685,84575,1286260
2058,ssp126,A359,81063,652964,232550,966577,319683,1286260
2058,ssp126,B39m,15471,493443,512385,1021299,264961,1286260
2058,ssp126,B789,23486,525622,267551,816659,469601,1286260
2058,ssp245,A20n,834213,312506,54526,1201245,85015,1286260
2058,ssp245,A359,77054,655908,230929,963891,322369,1286260
2058,ssp245,B39m,13747,493438,512289,1019474,266786,1286260
2058,ssp245,B789,21577,525348,265587,812512,473748,1286260
2058,ssp370,A20n,830516,315978,54482,1200976,85284,1286260
2058,ssp370,A359,74266,657420,230039,961725,324535,1286260
2058,ssp370,B39m,13150,492237,513070,1018457,267803,1286260
2058,ssp370,B789,20341,525167,263391,808899,477361,1286260
2058,ssp585,A20n,832144,314067,55197,1201408,84852,1286260
2058,ssp585,A359,78953,652114,232213,963280,322980,1286260
2058,ssp585,B39m,15152,491393,513058,1019603,266657,1286260
2058,ssp585,B789,22961,523529,264444,810934,475326,1286260
2059,ssp126,A20n,836150,311298,54369,1201817,84443,1286260
2059,ssp126,A359,77750,655203,232940,965893,320367,1286260
2059,ssp126,B39m,14124,493394,512922,1020440,265820,1286260
2059,ssp126,B789,22102,525786,266581,814469,471791,1286260
2059,ssp245,A20n,831766,315067,54988,1201821,84439,1286260
2059,ssp245,A359,77730,654334,230591,962655,323605,1286260
2059,ssp245,B39m,14537,491050,513723,1019310,266950,1286260
2059,ssp245,B789,22252,523652,264259,810163,476097,1286260
2059,ssp370,A20n,829830,315905,54675,1200410,85850,1286260
2059,ssp370,A359,76969,654126,229139,960234,326026,1286260
2059,ssp370,B39m,14470,490015,513499,1017984,268276,1286260
2059,ssp370,B789,22077,522820,263447,808344,477916,1286260
2059,ssp585,A20n,830930,315415,54690,1201035,85225,1286260
2059,ssp585,A359,75728,656388,229227,961343,324917,1286260
2059,ssp585,B39m,13465,491807,513665,1018937,267323,1286260
2059,ssp585,B789,20948,524743,263722,809413,476847,1286260
2060,ssp126,A20n,835909,314237,54733,1204879,84905,1289784
2060,ssp126,A359,78456,656711,231814,966981,322803,1289784
2060,ssp126,B39m,14552,493280,514632,1022464,267320,1289784
2060,ssp126,B789,22348,525974,266257,814579,475205,1289784
2060,ssp245,A20n,835920,313954,54929,1204803,84981,1289784
2060,ssp245,A359,77751,656642,232692,967085,322699,1289784
2060,ssp245,B39m,14078,493830,514570,1022478,267306,1289784
2060,ssp245,B789,21654,526580,266385,814619,475165,1289784
2060,ssp370,A20n,834607,314218,55544,1204369,85415,1289784
2060,ssp370,A359,77542,656851,230517,964910,324874,1289784
2060,ssp370,B39m,14547,493408,513505,1021460,268324,1289784
2060,ssp370,B789,22338,526382,264374,813094,476690,1289784
2060,ssp585,A20n,830703,318813,54001,1203517,86267,1289784
2060,ssp585,A359,74123,658331,229783,962237,327547,1289784
2060,ssp585,B39m,12593,493113,514091,1019797,269987,1289784
2060,ssp585,B789,19848,526449,262450,808747,481037,1289784
2061,ssp126,A20n,835049,311592,54547,1201188,85072,1286260
2061,ssp126,A359,79456,653589,233251,966296,319964,1286260
2061,ssp126,B39m,14953,492016,514528,1021497,264763,1286260
2061,ssp126,B789,22731,524535,266610,813876,472384,1286260
2061,ssp245,A20n,834784,311665,54790,1201239,85021,1286260
2061,ssp245,A359,81297,650906,233064,965267,320993,1286260
2061,ssp245,B39m,15842,491362,513504,1020708,265552,1286260
2061,ssp245,B789,23786,523530,266198,813514,472746,1286260
2061,ssp370,A20n,831386,314566,54757,1200709,85551,1286260
2061,ssp370,A359,76198,654654,231211,962063,324197,1286260
2061,ssp370,B39m,13856,491925,512802,1018583,267677,1286260
2061,ssp370,B789,21417,524279,263768,809464,476796,1286260
2061,ssp585,A20n,830980,314734,54806,1200520,85740,1286260
2061,ssp585,A359,75380,655469,229179,960028,326232,1286260
2061,ssp585,B39m,13401,490982,513242,1017625,268635,1286260
2061,ssp585,B789,20942,524145,264474,809561,476699,1286260
2062,ssp126,A20n,834631,312549,54778,1201958,84302,1286260
2062,ssp126,A359,79132,654658,232356,966146,320114,1286260
2062,ssp126,B39m,14965,492790,513348,1021103,265157,1286260
2062,ssp126,B789,22790,525012,265525,813327,472933,1286260
2062,ssp245,A20n,834506,312396,54580,1201482,84778,1286260
2062,ssp245,A359,78264,654417,232065,964746,321514,1286260
2062,ssp245,B39m,14236,492460,514058,1020754,265506,1286260
2062,ssp245,B789,22100,524661,266714,813475,472785,1286260
2062,ssp370,A20n,833133,313747,54350,1201230,85030,1286260
2062,ssp370,A359,76651,655835,230560,963046,323214,1286260
2062,ssp370,B39m,13793,491863,514212,1019868,266392,1286260
2062,ssp370,B789,21473,524832,265501,811806,474454,1286260
2062,ssp585,A20n,830436,315590,55224,1201250,85010,1286260
2062,ssp585,A359,79643,650507,231025,961175,325085,1286260
2062,ssp585,B39m,15513,488135,513898,1017546,268714,1286260
2062,ssp585,B789,23436,521338,264337,809111,477149,1286260
2063,ssp126,A20n,837142,309526,54706,1201374,84886,1286260
2063,ssp126,A359,80511,652692,233824,967027,319233,1286260
2063,ssp126,B39m,15263,492294,514035,1021592,264668,1286260
2063,ssp126,B789,23400,524339,268201,815940,470320,1286260
2063,ssp245,A20n,832717,314373,54049,1201139,85121,1286260
2063,ssp245,A359,79211,652505,231610,963326,322934,1286260
2063,ssp245,B39m,14884,491537,513339,1019760,266500,1286260
2063,ssp245,B789,22832,522697,265569,811098,475162,1286260
2063,ssp370,A20n,832447,313741,54514,1200702,85558,1286260
2063,ssp370,A359,77911,652667,231304,961882,324378,1286260
2063,ssp370,B39m,14262,490274,514320,1018856,267404,1286260
2063,ssp370,B789,22212,522479,265810,810501,475759,1286260
2063,ssp585,A20n,827970,317350,55292,1200612,85648,1286260
2063,ssp585,A359,75815,654454,230612,960881,325379,1286260
2063,ssp585,B39m,13755,491001,512772,1017528,268732,1286260
2063,ssp585,B789,21433,523643,261357,806433,479827,1286260
2064,ssp126,A20n,837038,313378,54997,1205413,84371,1289784
2064,ssp126,A359,78498,656940,232389,967827,321957,1289784
2064,ssp126,B39m,14645,494273,514913,1023831,265953,1289784
2064,ssp126,B789,22347,526503,267183,816033,473751,1289784
2064,ssp245,A20n,834406,315525,54782,1204713,85071,1289784
2064,ssp245,A359,77134,656583,231655,965372,324412,1289784
2064,ssp245,B39m,14287,492722,514360,1021369,268415,1289784
2064,ssp245,B789,22107,525066,265441,812614,477170,1289784
2064,ssp370,A20n,834187,314271,55681,1204139,85645,1289784
2064,ssp370,A359,78625,653577,232631,964833,324951,1289784
2064,ssp370,B39m,14954,490118,516127,1021199,268585,1289784
2064,ssp370,B789,22821,522922,267323,813066,476718,1289784
2064,ssp585,A20n,831173,317790,55471,1204434,85350,1289784
2064,ssp585,A359,75549,656639,230917,963105,326679,1289784
2064,ssp585,B39m,13547,491823,515962,1021332,268452,1289784
2064,ssp585,B789,21134,525013,263348,809495,480289,1289784
2065,ssp126,A20n,835351,312485,54241,1202077,84183,1286260
2065,ssp126,A359,79055,654012,232890,965957,320303,1286260
2065,ssp126,B39m,14779,492203,514181,1021163,265097,1286260
2065,ssp126,B789,22882,524266,267126,814274,471986,1286260
2065,ssp245,A20n,830861,316611,54653,1202125,84135,1286260
2065,ssp245,A359,75873,655836,231145,962854,323406,1286260
2065,ssp245,B39m,14061,492002,513786,1019849,266411,1286260
2065,ssp245,B789,21535,524247,263220,809002,477258,1286260
2065,ssp370,A20n,830061,316013,55034,1201108,85152,1286260
2065,ssp370,A359,75008,656775,229141,960924,325336,1286260
2065,ssp370,B39m,13565,491838,511909,1017312,268948,1286260
2065,ssp370,B789,20777,525432,262659,808868,477392,1286260
2065,ssp585,A20n,826261,318906,54734,1199901,86359,1286260
2065,ssp585,A359,72935,655163,228762,956860,329400,1286260
2065,ssp585,B39m,13058,489132,513308,1015498,270762,1286260
2065,ssp585,B789,20349,522182,261744,804275,481985,1286260
2066,ssp126,A20n,834409,312414,54224,1201047,85213,1286260
2066,ssp126,A359,76495,657016,231100,964611,321649,1286260
2066,ssp126,B39m,13830,494012,511839,1019681,266579,1286260
2066,ssp126,B789,21686,525808,265616,813110,473150,1286260
2066,ssp245,A20n,830471,315272,54878,1200621,85639,1286260
2066,ssp245,A359,77546,652974,230514,961034,325226,1286260
2066,ssp245,B39m,14697,489072,514315,1018084,268176,1286260
2066,ssp245,B789,22669,521548,264564,808781,477479,1286260
2066,ssp370,A20n,830624,314998,54969,1200591,85669,1286260
2066,ssp370,A359,77929,653011,230238,961178,325082,1286260
2066,ssp370,B39m,14447,490288,512820,1017555,268705,1286260
2066,ssp370,B789,22078,523308,263292,808678,477582,1286260
2066,ssp585,A20n,831151,314050,55452,1200653,85607,1286260
2066,ssp585,A359,75342,655830,229061,960233,326027,1286260
2066,ssp585,B39m,13696,490911,512554,1017161,269099,1286260
2066,ssp585,B789,21137,524376,264162,809675,476585,1286260
2067,ssp126,A20n,834565,312411,54579,1201555,84705,1286260
2067,ssp126,A359,78331,654658,231208,964197,322063,1286260
2067,ssp126,B39m,14677,491375,514094,1020146,266114,1286260
2067,ssp126,B789,22655,523207,266874,812736,473524,1286260
2067,ssp245,A20n,832490,313700,54968,1201158,85102,1286260
2067,ssp245,A359,77981,653916,231938,963835,322425,1286260
2067,ssp245,B39m,14309,491849,513306,1019464,266796,1286260
2067,ssp245,B789,22008,524421,264671,811100,475160,1286260
2067,ssp370,A20n,827379,318800,54795,1200974,85286,1286260
2067,ssp370,A359,74000,656265,228205,958470,327790,1286260
2067,ssp370,B39m,13297,490896,512593,1016786,269474,1286260
2067,ssp370,B789,20820,523706,260732,805258,481002,1286260
2067,ssp585,A20n,829389,316054,54585,1200028,86232,1286260
2067,ssp585,A359,73693,657325,229299,960317,325943,1286260
2067,ssp585,B39m,13140,491221,512616,1016977,269283,1286260
2067,ssp585,B789,20759,524468,262210,807437,478823,1286260
2068,ssp126,A20n,838142,311833,54522,1204497,85287,1289784
2068,ssp126,A359,80378,654891,232944,968213,321571,1289784
2068,ssp126,B39m,15365,493645,514746,1023756,266028,1289784
2068,ssp126,B789,23512,525646,267339,816497,473287,1289784
2068,ssp245,A20n,835897,314450,54418,1204765,85019,1289784
2068,ssp245,A359,80023,654788,233015,967826,321958,1289784
2068,ssp245,B39m,15381,492696,515381,1023458,266326,1289784
2068,ssp245,B789,23099,525575,266114,814788,474996,1289784
2068,ssp370,A20n,830506,318222,54732,1203460,86324,1289784
2068,ssp370,A359,76104,656351,228987,961442,328342,1289784
2068,ssp370,B39m,13789,491648,514125,1019562,270222,1289784
2068,ssp370,B789,21345,524467,262398,808210,481574,1289784
2068,ssp585,A20n,830721,318334,55247,1204302,85482,1289784
2068,ssp585,A359,74895,657535,230829,963259,326525,1289784
2068,ssp585,B39m,13631,492086,514986,1020703,269081,1289784
2068,ssp585,B789,21241,525490,262365,809096,480688,1289784
2069,ssp126,A20n,834311,313425,53823,1201559,84701,1286260
2069,ssp126,A359,77636,655946,231926,965508,320752,1286260
2069,ssp126,B39m,14049,493404,513370,1020823,265437,1286260
2069,ssp126,B789,21742,525650,265427,812819,473441,1286260
2069,ssp245,A20n,833791,312730,54729,1201250,85010,1286260
2069,ssp245,A359,79901,652202,232240,964343,321917,1286260
2069,ssp245,B39m,15118,491815,512759,1019692,266568,1286260
2069,ssp245,B789,22965,523972,265849,812786,473474,1286260
2069,ssp370,A20n,830986,314681,55384,1201051,85209,1286260
2069,ssp370,A359,77831,653118,230037,960986,325274,1286260
2069,ssp370,B39m,14522,490024,513541,1018087,268173,1286260
2069,ssp370,B789,22136,523257,264210,809603,476657,1286260
2069,ssp585,A20n,829833,316157,54712,1200702,85558,1286260
2069,ssp585,A359,76455,654101,229605,960161,326099,1286260
2069,ssp585,B39m,13934,489838,513613,1017385,268875,1286260
2069,ssp585,B789,21524,523202,263323,808049,478211,1286260
2070,ssp126,A20n,834267,313580,54073,1201920,84340,1286260
2070,ssp126,A359,77717,656406,230816,964939,321321,1286260
2070,ssp126,B39m,14155,494299,512462,1020916,265344,1286260
2070,ssp126,B789,21885,526095,264751,812731,473529,1286260
2070,ssp245,A20n,834194,312004,55136,1201334,84926,1286260
2070,ssp245,A359,80269,652089,231470,963828,322432,1286260
2070,ssp245,B39m,15223,490430,514024,1019677,266583,1286260
2070,ssp245,B789,23391,523229,266032,812652,473608,1286260
2070,ssp370,A20n,829633,316177,54895,1200705,85555,1286260
2070,ssp370,A359,77383,653159,229844,960386,325874,1286260
2070,ssp370,B39m,14611,489533,513438,1017582,268678,1286260
2070,ssp370,B789,22280,522769,263295,808344,477916,1286260
2070,ssp585,A20n,823635,322261,54513,1200409,85851,1286260
2070,ssp585,A359,70856,657554,228172,956582,329678,1286260
2070,ssp585,B39m,12349,489490,513524,1015363,270897,1286260
2070,ssp585,B789,19278,523608,258648,801534,484726,1286260
2071,ssp126,A20n,836529,310649,54581,1201759,84501,1286260
2071,ssp126,A359,81708,651525,234346,967579,318681,1286260
2071,ssp126,B39m,15379,492773,513649,1021801,264459,1286260
2071,ssp126,B789,23589,524005,267656,815250,471010,1286260
2071,ssp245,A20n,830068,316413,54461,1200942,85318,1286260
2071,ssp245,A359,77184,653799,230276,961259,325001,1286260
2071,ssp245,B39m,14220,490111,513598,1017929,268331,1286260
2071,ssp245,B789,21729,523233,264129,809091,477169,1286260
2071,ssp370,A20n,828355,317466,54525,1200346,85914,1286260
2071,ssp370,A359,73668,656507,229442,959617,326643,1286260
2071,ssp370,B39m,13127,491057,512341,1016525,269735,1286260
2071,ssp370,B789,20324,524372,262082,806778,479482,1286260
2071,ssp585,A20n,828307,316639,55245,1200191,86069,1286260
2071,ssp585,A359,76155,653561,228668,958384,327876,1286260
2071,ssp585,B39m,13997,488561,513410,1015968,270292,1286260
2071,ssp585,B789,21450,522276,262706,806432,479828,1286260
2072,ssp126,A20n,839059,310730,55190,1204979,84805,1289784
2072,ssp126,A359,80995,654625,233529,969149,320635,1289784
2072,ssp126,B39m,14836,494381,514914,1024131,265653,1289784
2072,ssp126,B789,23372,526094,268410,817876,471908,1289784
2072,ssp245,A20n,834550,315101,54910,1204561,85223,1289784
2072,ssp245,A359,76869,657910,230690,965469,324315,1289784
2072,ssp245,B39m,13806,493797,514007,1021610,268174,1289784
2072,ssp245,B789,21235,527183,265018,813436,476348,1289784
2072,ssp370,A20n,830288,318624,54974,1203886,85898,1289784
2072,ssp370,A359,74408,657840,230118,962366,327418,1289784
2072,ssp370,B39m,13309,492524,514661,1020494,269290,1289784
2072,ssp370,B789,20906,525424,262121,808451,481333,1289784
2072,ssp585,A20n,830742,318010,54927,1203679,86105,1289784
2072,ssp585,A359,75515,656006,230164,961685,328099,1289784
2072,ssp585,B39m,14245,489950,515517,1019712,270072,1289784
2072,ssp585,B789,21837,523734,263402,808973,480811,1289784
2073,ssp126,A20n,834248,312660,54596,1201504,84756,1286260
2073,ssp126,A359,77188,655527,231595,964310,321950,1286260
2073,ssp126,B39m,14451,492862,513017,1020330,265930,1286260
2073,ssp126,B789,22129,524780,265973,812882,473378,1286260
2073,ssp245,A20n,833487,314039,54206,1201732,84528,1286260
2073,ssp245,A359,76389,656631,230902,963922,322338,1286260
2073,ssp245,B39m,14204,492089,514148,1020441,265819,1286260
2073,ssp245,B789,21676,525260,265340,812276,473984,1286260
2073,ssp370,A20n,827736,317900,54953,1200589,85671,1286260
2073,ssp370,A359,72845,657465,229023,959333,326927,1286260
2073,ssp370,B39m,12564,491547,512396,1016507,269753,1286260
2073,ssp370,B789,19795,524723,261353,805871,480389,1286260
2073,ssp585,A20n,824578,320323,55108,1200009,86251,1286260
2073,ssp585,A359,73194,655976,227413,956583,329677,1286260
2073,ssp585,B39m,13170,489409,513150,1015729,270531,1286260
2073,ssp585,B789,20572,523261,258452,802285,483975,1286260
2074,ssp126,A20n,836506,310598,54554,1201658,84602,1286260
2074,ssp126,A359,80135,653449,233138,966722,319538,1286260
2074,ssp126,B39m,15251,492530,513911,1021692,264568,1286260
2074,ssp126,B789,23354,523987,267781,815122,471138,1286260
2074,ssp245,A20n,833807,312827,54810,1201444,84816,1286260
2074,ssp245,A359,76953,655362,231590,963905,322355,1286260
2074,ssp245,B39m,14031,492226,514147,1020404,265856,1286260
2074,ssp245,B789,21520,524623,265835,811978,474282,1286260
2074,ssp370,A20n,828916,316401,55192,1200509,85751,1286260
2074,ssp370,A359,74166,655867,228749,958782,327478,1286260
2074,ssp370,B39m,13685,489668,513330,1016683,269577,1286260
2074,ssp370,B789,21227,522875,262759,806861,479399,1286260
2074,ssp585,A20n,828400,316536,55512,1200448,85812,1286260
2074,ssp585,A359,77573,651708,229208,958489,327771,1286260
2074,ssp585,B39m,14856,487787,513865,1016508,269752,1286260
2074,ssp585,B789,22491,521429,262855,806775,479485,1286260
2075,ssp126,A20n,838154,308381,55237,1201772,84488,1286260
2075,ssp126,A359,82076,651722,232806,966604,319656,1286260
2075,ssp126,B39m,15947,492216,513576,1021739,264521,1286260
2075,ssp126,B789,24366,523508,268975,816849,469411,1286260
2075,ssp245,A20n,833591,312239,55131,1200961,85299,1286260
2075,ssp245,A359,77914,655018,229864,962796,323464,1286260
2075,ssp245,B39m,14684,491652,513160,1019496,266764,1286260
2075,ssp245,B789,22203,524575,265418,812196,474064,1286260
2075,ssp370,A20n,828031,316843,55766,1200640,85620,1286260
2075,ssp370,A359,75542,654567,228981,959090,327170,1286260
2075,ssp370,B39m,13600,490362,512151,1016113,270147,1286260
2075,ssp370,B789,21132,524125,261142,806399,479861,1286260
2075,ssp585,A20n,824253,320777,55224,1200254,86006,1286260
2075,ssp585,A359,74922,653693,228855,957470,328790,1286260
2075,ssp585,B39m,13525,488914,513424,1015863,270397,1286260
2075,ssp585,B789,21059,522735,259214,803008,483252,1286260
2076,ssp126,A20n,836600,313656,54316,1204572,85212,1289784
2076,ssp126,A359,80094,654317,233555,967966,321818,1289784
2076,ssp126,B39m,15178,493936,514338,1023452,266332,1289784
2076,ssp126,B789,23290,525303,266376,814969,474815,1289784
2076,ssp245,A20n,830558,319174,54600,1204332,85452,1289784
2076,ssp245,A359,74439,658204,231183,963826,325958,1289784
2076,ssp245,B39m,13213,492913,514776,1020902,268882,1289784
2076,ssp245,B789,20540,525707,262347,808594,481190,1289784
2076,ssp370,A20n,831808,317575,54577,1203960,85824,1289784
2076,ssp370,A359,73976,658299,229780,962055,327729,1289784
2076,ssp370,B39m,13391,492148,514383,1019922,269862,1289784
2076,ssp370,B789,20695,525646,263455,809796,479988,1289784
2076,ssp585,A20n,829066,319427,54952,1203445,86339,1289784
2076,ssp585,A359,76168,654417,230614,961199,328585,1289784
2076,ssp585,B39m,14021,490183,514918,1019122,270662,1289784
2076,ssp585,B789,21649,523638,262081,807368,482416,1289784
2077,ssp126,A20n,836819,309920,54944,1201683,84577,1286260
2077,ssp126,A359,81074,652035,233125,966234,320026,1286260
2077,ssp126,B39m,15715,490964,514498,1021177,265083,1286260
2077,ssp126,B789,24212,522700,268869,815781,470479,1286260
2077,ssp245,A20n,832416,313175,55113,1200704,85556,1286260
2077,ssp245,A359,76427,656195,229310,961932,324328,1286260
2077,ssp245,B39m,13698,492915,511480,1018093,268167,1286260
2077,ssp245,B789,21364,525410,263902,810676,475584,1286260
2077,ssp370,A20n,830673,314315,55627,1200615,85645,1286260
2077,ssp370,A359,77107,653626,230591,961324,324936,1286260
2077,ssp370,B39m,14338,491329,512136,1017803,268457,1286260
2077,ssp370,B789,21968,524174,263186,809328,476932,1286260
2077,ssp585,A20n,827533,318044,54717,1200294,85966,1286260
2077,ssp585,A359,76016,653311,229557,958884,327376,1286260
2077,ssp585,B39m,14127,487933,514384,1016444,269816,1286260
2077,ssp585,B789,21692,522043,261790,805525,480735,1286260
2078,ssp126,A20n,836610,310491,54998,1202099,84161,1286260
2078,ssp126,A359,80357,653315,232881,966553,319707,1286260
2078,ssp126,B39m,15238,492225,514497,1021960,264300,1286260
2078,ssp126,B789,23489,523823,268035,815347,470913,1286260
2078,ssp245,A20n,833214,313666,54388,1201268,84992,1286260
2078,ssp245,A359,77676,654820,231273,963769,322491,1286260
2078,ssp245,B39m,14737,492112,512672,1019521,266739,1286260
2078,ssp245,B789,22396,524893,264602,811891,474369,1286260
2078,ssp370,A20n,827465,317571,55303,1200339,85921,1286260
2078,ssp370,A359,74631,654897,228504,958032,328228,1286260
2078,ssp370,B39m,13373,490474,512119,1015966,270294,1286260
2078,ssp370,B789,20709,523159,261949,805817,480443,1286260
2078,ssp585,A20n,826274,318611,55112,1199997,86263,1286260
2078,ssp585,A359,75512,652984,229120,957616,328644,1286260
2078,ssp585,B39m,14061,488657,513314,1016032,270228,1286260
2078,ssp585,B789,21570,522467,260907,804944,481316,1286260
2079,ssp126,A20n,836224,310722,54571,1201517,84743,1286260
2079,ssp126,A359,79121,654450,232223,965794,320466,1286260
2079,ssp126,B39m,14725,493653,512674,1021052,265208,1286260
2079,ssp126,B789,22751,525300,266924,814975,471285,1286260
2079,ssp245,A20n,832826,312905,55326,1201057,85203,1286260
2079,ssp245,A359,78624,653308,231511,963443,322817,1286260
2079,ssp245,B39m,14491,491414,512892,1018797,267463,1286260
2079,ssp245,B789,22290,523723,265611,811624,474636,1286260
2079,ssp370,A20n,826380,318672,55022,1200074,86186,1286260
2079,ssp370,A359,72700,656949,228707,958356,327904,1286260
2079,ssp370,B39m,12701,490980,512298,1015979,270281,1286260
2079,ssp370,B789,20016,524189,260711,804916,481344,1286260
2079,ssp585,A20n,825014,319738,55789,1200541,85719,1286260
2079,ssp585,A359,73882,654763,228617,957262,328998,1286260
2079,ssp585,B39m,13537,489343,513117,1015997,270263,1286260
2079,ssp585,B789,20701,523232,259011,802944,483316,1286260
2080,ssp126,A20n,840810,309806,55111,1205727,84057,1289784
2080,ssp126,A359,80988,655494,235223,971705,318079,1289784
2080,ssp126,B39m,15409,495634,514935,1025978,263806,1289784
2080,ssp126,B789,23525,527624,268067,819216,470568,1289784
2080,ssp245,A20n,833591,315893,54964,1204448,85336,1289784
2080,ssp245,A359,78272,655417,231620,965309,324475,1289784
2080,ssp245,B39m,15044,491861,514960,1021865,267919,1289784
2080,ssp245,B789,23038,524656,264281,811975,477809,1289784
2080,ssp370,A20n,831823,317246,55065,1204134,85650,1289784
2080,ssp370,A359,76839,655477,230392,962708,327076,1289784
2080,ssp370,B39m,13635,492376,515061,1021072,268712,1289784
2080,ssp370,B789,21393,525683,263024,810100,479684,1289784
2080,ssp585,A20n,825455,323353,54825,1203633,86151,1289784
2080,ssp585,A359,72364,657421,228773,958558,331226,1289784
2080,ssp585,B39m,12805,490051,515460,1018316,271468,1289784
2080,ssp585,B789,19833,524858,258740,803431,486353,1289784
2081,ssp126,A20n,836451,311048,53643,1201142,85118,1286260
2081,ssp126,A359,78694,654981,233150,966825,319435,1286260
2081,ssp126,B39m,14784,493694,512637,1021115,265145,1286260
2081,ssp126,B789,22640,525538,266749,814927,471333,1286260
2081,ssp245,A20n,831532,315442,54325,1201299,84961,1286260
2081,ssp245,A359,76362,655245,230363,961970,324290,1286260
2081,ssp245,B39m,14112,490284,514426,1018822,267438,1286260
2081,ssp245,B789,21623,523706,264739,810068,476192,1286260
2081,ssp370,A20n,828327,316461,55497,1200285,85975,1286260
2081,ssp370,A359,74708,655956,228317,958981,327279,1286260
2081,ssp370,B39m,13740,490629,511501,1015870,270390,1286260
2081,ssp370,B789,21243,524106,261684,807033,479227,1286260
2081,ssp585,A20n,823727,320328,55714,1199769,86491,1286260
2081,ssp585,A359,72601,655278,226910,954789,331471,1286260
2081,ssp585,B39m,13056,487808,513025,1013889,272371,1286260
2081,ssp585,B789,20435,522103,259882,802420,483840,1286260
2082,ssp126,A20n,834147,312660,54655,1201462,84798,1286260
2082,ssp126,A359,78520,654864,232137,965521,320739,1286260
2082,ssp126,B39m,14912,493144,511628,1019684,266576,1286260
2082,ssp126,B789,22640,525165,265227,813032,473228,1286260
2082,ssp245,A20n,832956,313387,54653,1200996,85264,1286260
2082,ssp245,A359,77676,654213,230896,962785,323475,1286260
2082,ssp245,B39m,14760,491403,513824,1019987,266273,1286260
2082,ssp245,B789,22470,523747,265127,811344,474916,1286260
2082,ssp370,A20n,830174,315639,54936,1200749,85511,1286260
2082,ssp370,A359,73584,656614,230283,960481,325779,1286260
2082,ssp370,B39m,12857,490821,514108,1017786,268474,1286260
2082,ssp370,B789,20068,524193,263929,808190,478070,1286260
2082,ssp585,A20n,824969,320322,55100,1200391,85869,1286260
2082,ssp585,A359,72871,655050,228925,956846,329414,1286260
2082,ssp585,B39m,13066,489234,513979,1016279,269981,1286260
2082,ssp585,B789,20291,522768,260004,803063,483197,1286260
2083,ssp126,A20n,837238,309403,55033,1201674,84586,1286260
2083,ssp126,A359,83415,649799,233528,966742,319518,1286260
2083,ssp126,B39m,16657,491373,512361,1020391,265869,1286260
2083,ssp126,B789,25428,522305,268448,816181,470079,1286260
2083,ssp245,A20n,833614,312466,55156,1201236,85024,1286260
2083,ssp245,A359,80767,651376,231277,963420,322840,1286260
2083,ssp245,B39m,15595,490646,513248,1019489,266771,1286260
2083,ssp245,B789,23660,523306,265428,812394,473866,1286260
2083,ssp370,A20n,829337,316465,54923,1200725,85535,1286260
2083,ssp370,A359,73950,655700,229631,959281,326979,1286260
2083,ssp370,B39m,13148,489676,514598,1017422,268838,1286260
2083,ssp370,B789,20515,523504,263267,807286,478974,1286260
2083,ssp585,A20n,824366,319866,55364,1199596,86664,1286260
2083,ssp585,A359,73184,653741,226203,953128,333132,1286260
2083,ssp585,B39m,13261,486185,514435,1013881,272379,1286260
2083,ssp585,B789,20957,520358,260951,802266,483994,1286260
2084,ssp126,A20n,838354,312641,54146,1205141,84643,1289784
2084,ssp126,A359,77957,658401,232494,968852,320932,1289784
2084,ssp126,B39m,14335,494989,514975,1024299,265485,1289784
2084,ssp126,B789,22035,527152,268006,817193,472591,1289784
2084,ssp245,A20n,834560,315218,55128,1204906,84878,1289784
2084,ssp245,A359,79471,654603,232294,966368,323416,1289784
2084,ssp245,B39m,15194,492439,514888,1022521,267263,1289784
2084,ssp245,B789,23087,525647,264193,812927,476857,1289784
2084,ssp370,A20n,828651,319276,55351,1203278,86506,1289784
2084,ssp370,A359,73118,657821,229468,960407,329377,1289784
2084,ssp370,B39m,13179,491154,513904,1018237,271547,1289784
2084,ssp370,B789,20361,524939,261155,806455,483329,1289784
2084,ssp585,A20n,828134,319361,55266,1202761,87023,1289784
2084,ssp585,A359,74298,655996,228662,958956,330828,1289784
2084,ssp585,B39m,13327,490511,514066,1017904,271880,1289784
2084,ssp585,B789,20741,524230,261219,806190,483594,1289784
2085,ssp126,A20n,834227,313131,54372,1201730,84530,1286260
2085,ssp126,A359,78471,654505,232229,965205,321055,1286260
2085,ssp126,B39m,14141,493455,513308,1020904,265356,1286260
2085,ssp126,B789,21890,525687,265194,812771,473489,1286260
2085,ssp245,A20n,829495,316493,54941,1200929,85331,1286260
2085,ssp245,A359,75155,655162,229891,960208,326052,1286260
2085,ssp245,B39m,13729,490659,512841,1017229,269031,1286260
2085,ssp245,B789,21231,523454,262956,807641,478619,1286260
2085,ssp370,A20n,828060,317337,54964,1200361,85899,1286260
2085,ssp370,A359,75923,654222,228913,959058,327202,1286260
2085,ssp370,B39m,14234,489250,513333,1016817,269443,1286260
2085,ssp370,B789,21521,523392,261867,806780,479480,1286260
2085,ssp585,A20n,823824,321048,55215,1200087,86173,1286260
2085,ssp585,A359,74786,652659,227440,954885,331375,1286260
2085,ssp585,B39m,14019,486951,513829,1014799,271461,1286260
2085,ssp585,B789,21300,520960,260044,802304,483956,1286260
2086,ssp126,A20n,835041,311536,55113,1201690,84570,1286260
2086,ssp126,A359,78681,655184,231463,965328,320932,1286260
2086,ssp126,B39m,14316,493348,512616,1020280,265980,1286260
2086,ssp126,B789,22110,525501,266210,813821,472439,1286260
2086,ssp245,A20n,832409,314428,54602,1201439,84821,1286260
2086,ssp245,A359,78052,653592,231455,963099,323161,1286260
2086,ssp245,B39m,14725,491061,513760,1019546,266714,1286260
2086,ssp245,B789,22750,523737,263935,810422,475838,1286260
2086,ssp370,A20n,827328,318003,55442,1200773,85487,1286260
2086,ssp370,A359,73640,656093,228700,958433,327827,1286260
2086,ssp370,B39m,12944,490496,512771,1016211,270049,1286260
2086,ssp370,B789,20247,524321,261259,805827,480433,1286260
2086,ssp585,A20n,824235,320171,55190,1199596,86664,1286260
2086,ssp585,A359,75905,651478,227794,955177,331083,1286260
2086,ssp585,B39m,14479,486394,514117,1014990,271270,1286260
2086,ssp585,B789,22207,520243,260355,802805,483455,1286260
2087,ssp126,A20n,836458,310905,54555,1201918,84342,1286260
2087,ssp126,A359,79250,654674,232531,966455,319805,1286260
2087,ssp126,B39m,14748,493161,513573,1021482,264778,1286260
2087,ssp126,B789,22837,524948,267362,815147,471113,1286260
2087,ssp245,A20n,829611,316480,54646,1200737,85523,1286260
2087,ssp245,A359,74677,655736,230594,961007,325253,1286260
2087,ssp245,B39m,13654,491638,512935,1018227,268033,1286260
2087,ssp245,B789,20976,524531,262638,808145,478115,1286260
2087,ssp370,A20n,828342,316939,54917,1200198,86062,1286260
2087,ssp370,A359,75285,654269,230302,959856,326404,1286260
2087,ssp370,B39m,13194,490530,513483,1017207,269053,1286260
2087,ssp370,B789,20657,524396,261582,806635,479625,1286260
2087,ssp585,A20n,822277,321621,55693,1199591,86669,1286260
2087,ssp585,A359,72738,654394,227089,954221,332039,1286260
2087,ssp585,B39m,12917,487964,512874,1013755,272505,1286260
2087,ssp585,B789,19974,522218,257987,800179,486081,1286260
2088,ssp126,A20n,838235,311454,55033,1204722,85062,1289784
2088,ssp126,A359,80196,655469,233440,969105,320679,1289784
2088,ssp126,B39m,15257,494399,514391,1024047,265737,1289784
2088,ssp126,B789,23197,526478,267590,817265,472519,1289784
2088,ssp245,A20n,832749,317088,54760,1204597,85187,1289784
2088,ssp245,A359,77181,655762,231501,964444,325340,1289784
2088,ssp245,B39m,14026,493237,514085,1021348,268436,1289784
2088,ssp245,B789,21705,525994,262985,810684,479100,1289784
2088,ssp370,A20n,826721,321510,55544,1203775,86009,1289784
2088,ssp370,A359,71878,658813,228447,959138,330646,1289784
2088,ssp370,B39m,12529,491074,514676,1018279,271505,1289784
2088,ssp370,B789,19507,525774,259259,804540,485244,1289784
2088,ssp585,A20n,826120,321278,55321,1202719,87065,1289784
2088,ssp585,A359,73787,655543,226806,956136,333648,1289784
2088,ssp585,B39m,13065,489070,514157,1016292,273492,1289784
2088,ssp585,B789,20223,523592,260374,804189,485595,1289784
2089,ssp126,A20n,833435,313212,54601,1201248,85012,1286260
2089,ssp126,A359,79506,652573,232968,965047,321213,1286260
2089,ssp126,B39m,14782,492302,513377,1020461,265799,1286260
2089,ssp126,B789,22706,524175,265187,812068,474192,1286260
2089,ssp245,A20n,830782,316087,54396,1201265,84995,1286260
2089,ssp245,A359,76384,654954,231271,962609,323651,1286260
2089,ssp245,B39m,14042,491027,513994,1019063,267197,1286260
2089,ssp245,B789,21500,523943,263648,809091,477169,1286260
2089,ssp370,A20n,825454,319599,55051,1200104,86156,1286260
2089,ssp370,A359,74487,654090,228163,956740,329520,1286260
2089,ssp370,B39m,13631,487577,514072,1015280,270980,1286260
2089,ssp370,B789,20993,521004,261544,803541,482719,1286260
2089,ssp585,A20n,820100,323599,55518,1199217,87043,1286260
2089,ssp585,A359,69991,656314,227127,953432,332828,1286260
2089,ssp585,B39m,12169,487542,512669,1012380,273880,1286260
2089,ssp585,B789,19092,522269,256993,798354,487906,1286260
2090,ssp126,A20n,832073,314601,54540,1201214,85046,1286260
2090,ssp126,A359,76594,656052,231978,964624,321636,1286260
2090,ssp126,B39m,13709,494447,511850,1020006,266254,1286260
2090,ssp126,B789,21035,526488,263591,811114,475146,1286260
2090,ssp245,A20n,831870,314728,54683,1201281,84979,1286260
2090,ssp245,A359,78040,653527,230733,962300,323960,1286260
2090,ssp245,B39m,14764,490563,513944,1019271,266989,1286260
2090,ssp245,B789,22732,523065,264575,810372,475888,1286260
2090,ssp370,A20n,827416,318060,55158,1200634,85626,1286260
2090,ssp370,A359,73896,655734,227806,957436,328824,1286260
2090,ssp370,B39m,13402,489825,512514,1015741,270519,1286260
2090,ssp370,B789,20705,523567,261531,805803,480457,1286260
2090,ssp585,A20n,822733,322262,54859,1199854,86406,1286260
2090,ssp585,A359,71157,655840,227235,954232,332028,1286260
2090,ssp585,B39m,12354,487887,514315,1014556,271704,1286260
2090,ssp585,B789,19477,522172,258821,800470,485790,1286260
2091,ssp126,A20n,836554,310954,54699,1202207,84053,1286260
2091,ssp126,A359,79294,655197,232729,967220,319040,1286260
2091,ssp126,B39m,15222,493480,513630,1022332,263928,1286260
2091,ssp126,B789,22982,526194,266333,815509,470751,1286260
2091,ssp245,A20n,830396,315576,55225,1201197,85063,1286260
2091,ssp245,A359,77615,652857,231632,962104,324156,1286260
2091,ssp245,B39m,13825,491056,514080,1018961,267299,1286260
2091,ssp245,B789,21609,524571,262795,808975,477285,1286260
2091,ssp370,A20n,825463,318460,55698,1199621,86639,1286260
2091,ssp370,A359,74852,652935,228146,955933,330327,1286260
2091,ssp370,B39m,14083,488009,512609,1014701,271559,1286260
2091,ssp370,B789,21451,522231,259920,803602,482658,1286260
2091,ssp585,A20n,819004,324831,55353,1199188,87072,1286260
2091,ssp585,A359,70756,654298,226744,951798,334462,1286260
2091,ssp585,B39m,12777,486308,513526,1012611,273649,1286260
2091,ssp585,B789,20098,520685,255832,796615,489645,1286260
2092,ssp126,A20n,841300,309153,55140,1205593,84191,1289784
2092,ssp126,A359,81145,655985,232715,969845,319939,1289784
2092,ssp126,B39m,15284,495459,513207,1023950,265834,1289784
2092,ssp126,B789,23387,527688,269152,820227,469557,1289784
2092,ssp245,A20n,833200,316222,54954,1204376,85408,1289784
2092,ssp245,A359,77176,656730,231996,965902,323882,1289784
2092,ssp245,B39m,14099,493597,514308,1022004,267780,1289784
2092,ssp245,B789,21809,526719,262599,811127,478657,1289784
2092,ssp370,A20n,827407,320853,55194,1203454,86330,1289784
2092,ssp370,A359,74838,655906,229054,959798,329986,1289784
2092,ssp370,B39m,13781,490943,513640,1018364,271420,1289784
2092,ssp370,B789,21023,524642,259923,805588,484196,1289784
2092,ssp585,A20n,824284,322590,55719,1202593,87191,1289784
2092,ssp585,A359,73970,654387,227155,955512,334272,1289784
2092,ssp585,B39m,13734,487101,514993,1015828,273956,1289784
2092,ssp585,B789,21262,521284,260063,802609,487175,1289784
2093,ssp126,A20n,835490,311088,55091,1201669,84591,1286260
2093,ssp126,A359,79541,653765,233189,966495,319765,1286260
2093,ssp126,B39m,14961,493309,512691,1020961,265299,1286260
2093,ssp126,B789,22955,524966,266275,814196,472064,1286260
2093,ssp245,A20n,829862,316304,54285,1200451,85809,1286260
2093,ssp245,A359,74855,656134,230541,961530,324730,1286260
2093,ssp245,B39m,13230,492601,512440,1018271,267989,1286260
2093,ssp245,B789,20395,525291,262324,808010,478250,1286260
2093,ssp370,A20n,823632,321337,55008,1199977,86283,1286260
2093,ssp370,A359,70286,657608,227773,955667,330593,1286260
2093,ssp370,B39m,12667,489573,512362,1014602,271658,1286260
2093,ssp370,B789,19640,523659,258138,801437,484823,1286260
2093,ssp585,A20n,819195,324802,55313,1199310,86950,1286260
2093,ssp585,A359,70995,654429,226991,952415,333845,1286260
2093,ssp585,B39m,12574,487021,513370,1012965,273295,1286260
2093,ssp585,B789,19898,521864,255207,796969,489291,1286260
2094,ssp126,A20n,830953,315537,54446,1200936,85324,1286260
2094,ssp126,A359,77553,653889,231276,962718,323542,1286260
2094,ssp126,B39m,14189,492034,513748,1019971,266289,1286260
2094,ssp126,B789,21881,524150,263125,809156,477104,1286260
2094,ssp245,A20n,831828,314365,54946,1201139,85121,1286260
2094,ssp245,A359,77113,654268,230726,962107,324153,1286260
2094,ssp245,B39m,14574,490333,513625,1018532,267728,1286260
2094,ssp245,B789,22241,523065,264771,810077,476183,1286260
2094,ssp370,A20n,823076,321118,55509,1199703,86557,1286260
2094,ssp370,A359,72021,655118,227340,954479,331781,1286260
2094,ssp370,B39m,13188,487456,513565,1014209,272051,1286260
2094,ssp370,B789,20348,521367,259412,801127,485133,1286260
2094,ssp585,A20n,817661,326978,54440,1199079,87181,1286260
2094,ssp585,A359,67135,658521,225859,951515,334745,1286260
2094,ssp585,B39m,11433,487827,512935,1012195,274065,1286260
2094,ssp585,B789,18086,523127,254058,795271,490989,1286260
2095,ssp126,A20n,832603,314089,54518,1201210,85050,1286260
2095,ssp126,A359,79839,652025,231853,963717,322543,1286260
2095,ssp126,B39m,14962,490639,514423,1020024,266236,1286260
2095,ssp126,B789,22996,522675,265079,810750,475510,1286260
2095,ssp245,A20n,831385,315168,54599,1201152,85108,1286260
2095,ssp245,A359,76151,655249,231200,962600,323660,1286260
2095,ssp245,B39m,14148,490973,514005,1019126,267134,1286260
2095,ssp245,B789,21813,523624,264565,810002,476258,1286260
2095,ssp370,A20n,823531,322324,54670,1200525,85735,1286260
2095,ssp370,A359,70564,657468,226506,954538,331722,1286260
2095,ssp370,B39m,12013,489073,513421,1014507,271753,1286260
2095,ssp370,B789,18977,523708,258436,801121,485139,1286260
2095,ssp585,A20n,819332,324927,54817,1199076,87184,1286260
2095,ssp585,A359,67879,658154,225645,951678,334582,1286260
2095,ssp585,B39m,11290,487935,513516,1012741,273519,1286260
2095,ssp585,B789,17768,523231,256255,797254,489006,1286260
2096,ssp126,A20n,837036,313042,54992,1205070,84714,1289784
2096,ssp126,A359,80503,654602,233593,968698,321086,1289784
2096,ssp126,B39m,15402,492688,515760,1023850,265934,1289784
2096,ssp126,B789,23447,524482,267917,815846,473938,1289784
2096,ssp245,A20n,834691,314313,54678,1203682,86102,1289784
2096,ssp245,A359,78496,655122,230527,964145,325639,1289784
2096,ssp245,B39m,15445,491911,513560,1020916,268868,1289784
2096,ssp245,B789,23228,524472,265634,813334,476450,1289784
2096,ssp370,A20n,826576,321860,54676,1203112,86672,1289784
2096,ssp370,A359,70583,659248,227757,957588,332196,1289784
2096,ssp370,B39m,12442,490267,514429,1017138,272646,1289784
2096,ssp370,B789,19292,525672,259610,804574,485210,1289784
2096,ssp585,A20n,821954,324984,55358,1202296,87488,1289784
2096,ssp585,A359,68807,658809,226174,953790,335994,1289784
2096,ssp585,B39m,11897,488197,514785,1014879,274905,1289784
2096,ssp585,B789,18775,523626,257454,799855,489929,1289784
2097,ssp126,A20n,836580,310439,54938,1201957,84303,1286260
2097,ssp126,A359,80056,653264,233836,967156,319104,1286260
2097,ssp126,B39m,15559,492434,513363,1021356,264904,1286260
2097,ssp126,B789,23367,524669,267444,815480,470780,1286260
2097,ssp245,A20n,830421,316270,54139,1200830,85430,1286260
2097,ssp245,A359,74098,657587,229930,961615,324645,1286260
2097,ssp245,B39m,13591,491640,513435,1018666,267594,1286260
2097,ssp245,B789,20844,524430,263400,808674,477586,1286260
2097,ssp370,A20n,826198,318347,55402,1199947,86313,1286260
2097,ssp370,A359,72661,656646,227422,956729,329531,1286260
2097,ssp370,B39m,12829,490417,511695,1014941,271319,1286260
2097,ssp370,B789,20037,523755,260474,804266,481994,1286260
2097,ssp585,A20n,819963,323929,55604,1199496,86764,1286260
2097,ssp585,A359,68247,657281,226354,951882,334378,1286260
2097,ssp585,B39m,11905,486989,513702,1012596,273664,1286260
2097,ssp585,B789,18628,522229,256664,797521,488739,1286260
2098,ssp126,A20n,836977,309941,54835,1201753,84507,1286260
2098,ssp126,A359,82625,651460,233095,967180,319080,1286260
2098,ssp126,B39m,15931,492525,512797,1021253,265007,1286260
2098,ssp126,B789,24369,524075,267346,815790,470470,1286260
2098,ssp245,A20n,833684,312568,54812,1201064,85196,1286260
2098,ssp245,A359,78291,652933,232234,963458,322802,1286260
2098,ssp245,B39m,14292,491301,514051,1019644,266616,1286260
2098,ssp245,B789,22221,523912,266031,812164,474096,1286260
2098,ssp370,A20n,824091,320937,54829,1199857,86403,1286260
2098,ssp370,A359,71678,654842,227306,953826,332434,1286260
2098,ssp370,B39m,12413,487625,514666,1014704,271556,1286260
2098,ssp370,B789,19526,522081,260261,801868,484392,1286260
2098,ssp585,A20n,818562,325304,55230,1199096,87164,1286260
2098,ssp585,A359,66864,657708,224330,948902,337358,1286260
2098,ssp585,B39m,10762,486067,514368,1011197,275063,1286260
2098,ssp585,B789,17468,521694,257022,796184,490076,1286260
2099,ssp126,A20n,836033,310837,55281,1202151,84109,1286260
2099,ssp126,A359,80089,653220,233512,966821,319439,1286260
2099,ssp126,B39m,15636,492575,512809,1021020,265240,1286260
2099,ssp126,B789,23640,524544,266864,815048,471212,1286260
2099,ssp245,A20n,833204,313703,54588,1201495,84765,1286260
2099,ssp245,A359,78196,654321,231300,963817,322443,1286260
2099,ssp245,B39m,14907,491381,513204,1019492,266768,1286260
2099,ssp245,B789,22759,523966,264807,811532,474728,1286260
2099,ssp370,A20n,825476,319325,55641,1200442,85818,1286260
2099,ssp370,A359,74001,653770,226997,954768,331492,1286260
2099,ssp370,B39m,13499,487324,513434,1014257,272003,1286260
2099,ssp370,B789,21155,520916,261487,803558,482702,1286260
2099,ssp585,A20n,817987,325586,55409,1198982,87278,1286260
2099,ssp585,A359,68680,656228,224110,949018,337242,1286260
2099,ssp585,B39m,11682,486725,512933,1011340,274920,1286260
2099,ssp585,B789,18442,521569,255454,795465,490795,1286260
2100,ssp126,A20n,835427,310908,54798,1201133,85127,1286260
2100,ssp126,A359,80192,653217,232448,965857,320403,1286260
2100,ssp126,B39m,14689,493415,512790,1020894,265366,1286260
2100,ssp126,B789,22638,525549,265928,814115,472145,1286260
2100,ssp245,A20n,830003,315933,55060,1200996,85264,1286260
2100,ssp245,A359,76983,654383,230519,961885,324375,1286260
2100,ssp245,B39m,14273,492597,511573,1018443,267817,1286260
2100,ssp245,B789,21730,525972,260925,808627,477633,1286260
2100,ssp370,A20n,822618,321775,55203,1199596,86664,1286260
2100,ssp370,A359,72202,654212,228478,954892,331368,1286260
2100,ssp370,B39m,12860,487270,513786,1013916,272344,1286260
2100,ssp370,B789,20117,521781,258894,800792,485468,1286260
2100,ssp585,A20n,817075,327042,54898,1199015,87245,1286260
2100,ssp585,A359,69326,656128,224978,950432,335828,1286260
2100,ssp585,B39m,12897,486135,512469,1011501,274759,1286260
2100,ssp585,B789,19878,521210,253990,795078,491182,1286260
