year,exp,type,tko_ok_thr_min,tko_ok_thr_mid,tko_ok_thr_max,tko_ok,tko_ko,tko
2015,ssp126,Narrowbody,919098,961287,288401,2168786,401972,2570758
2015,ssp126,Widebody,40282,1017470,778967,1836719,734039,2570758
2015,ssp245,Narrowbody,922185,958585,289591,2170361,400397,2570758
2015,ssp245,Widebody,40661,1016990,782307,1839958,730800,2570758
2015,ssp370,Narrowbody,920530,959940,289829,2170299,400459,2570758
2015,ssp370,Widebody,39935,1017923,781140,1838998,731760,2570758
2015,ssp585,Narrowbody,918672,961010,290072,2169754,401004,2570758
2015,ssp585,Widebody,40861,1016363,780804,1838028,732730,2570758
2016,ssp126,Narrowbody,921628,963502,290347,2175477,404091,2579568
2016,ssp126,Widebody,40967,1019483,782374,1842824,736744,2579568
2016,ssp245,Narrowbody,925032,961962,289769,2176763,402805,2579568
2016,ssp245,Widebody,40668,1022074,783935,1846677,732891,2579568
2016,ssp370,Narrowbody,924069,963193,289636,2176898,402670,2579568
2016,ssp370,Widebody,40740,1019632,785465,1845837,733731,2579568
2016,ssp585,Narrowbody,919992,966384,289200,2175576,403992,2579568
2016,ssp585,Widebody,39463,1021413,780972,1841848,737720,2579568
2017,ssp126,Narrowbody,917199,965521,286461,2169181,403339,2572520
2017,ssp126,Widebody,38139,1020745,779026,1837910,734610,2572520
2017,ssp245,Narrowbody,919445,962178,288460,2170083,402437,2572520
2017,ssp245,Widebody,39054,1019807,779245,1838106,734414,2572520
2017,ssp370,Narrowbody,909091,969471,287578,2166140,406380,2572520
2017,ssp370,Widebody,34801,1019037,777591,1831429,741091,2572520
2017,ssp585,Narrowbody,917588,964188,288678,2170454,402066,2572520
2017,ssp585,Widebody,37472,1021089,779714,1838275,734245,2572520
2018,ssp126,Narrowbody,917696,964193,287102,2168991,403529,2572520
2018,ssp126,Widebody,37299,1020104,780267,1837670,734850,2572520
2018,ssp245,Narrowbody,912584,967906,286983,2167473,405047,2572520
2018,ssp245,Widebody,35918,1020482,778029,1834429,738091,2572520
2018,ssp370,Narrowbody,911678,968994,284957,2165629,406891,2572520
2018,ssp370,Widebody,36230,1018990,777667,1832887,739633,2572520
2018,ssp585,Narrowbody,913748,967515,287614,2168877,403643,2572520
2018,ssp585,Widebody,35946,1021010,779111,1836067,736453,2572520
2019,ssp126,Narrowbody,918353,964328,287588,2170269,402251,2572520
2019,ssp126,Widebody,39165,1018990,780994,1839149,733371,2572520
2019,ssp245,Narrowbody,911642,967845,286269,2165756,406764,2572520
2019,ssp245,Widebody,37313,1017613,778063,1832989,739531,2572520
2019,ssp370,Narrowbody,916877,962941,286325,2166143,406377,2572520
2019,ssp370,Widebody,39520,1014508,780372,1834400,738120,2572520
2019,ssp585,Narrowbody,919683,962833,286653,2169169,403351,2572520
2019,ssp585,Widebody,38576,1019157,780738,1838471,734049,2572520
2020,ssp126,Narrowbody,921633,964724,289917,2176274,403294,2579568
2020,ssp126,Widebody,38582,1022534,783825,1844941,734627,2579568
2020,ssp245,Narrowbody,924661,961876,289626,2176163,403405,2579568
2020,ssp245,Widebody,39871,1018823,786784,1845478,734090,2579568
2020,ssp370,Narrowbody,920612,965063,289956,2175631,403937,2579568
2020,ssp370,Widebody,39686,1021029,782240,1842955,736613,2579568
2020,ssp585,Narrowbody,921259,964523,289262,2175044,404524,2579568
2020,ssp585,Widebody,39865,1017967,785160,1842992,736576,2579568
2021,ssp126,Narrowbody,922227,960765,288401,2171393,401127,2572520
2021,ssp126,Widebody,39452,1018731,784749,1842932,729588,2572520
2021,ssp245,Narrowbody,914557,966599,287760,2168916,403604,2572520
2021,ssp245,Widebody,37033,1019251,778847,1835131,737389,2572520
2021,ssp370,Narrowbody,921724,959508,289161,2170393,402127,2572520
2021,ssp370,Widebody,41416,1016954,781879,1840249,732271,2572520
2021,ssp585,Narrowbody,914717,967107,286979,2168803,403717,2572520
2021,ssp585,Widebody,36652,1019992,780011,1836655,735865,2572520
2022,ssp126,Narrowbody,923839,958670,287784,2170293,402227,2572520
2022,ssp126,Widebody,41212,1017451,782305,1840968,731552,2572520
2022,ssp245,Narrowbody,912998,966502,287536,2167036,405484,2572520
2022,ssp245,Widebody,38273,1016508,778499,1833280,739240,2572520
2022,ssp370,Narrowbody,918035,963163,287871,2169069,403451,2572520
2022,ssp370,Widebody,38766,1017767,780642,1837175,735345,2572520
2022,ssp585,Narrowbody,913320,967991,286921,2168232,404288,2572520
2022,ssp585,Widebody,36672,1017889,780449,1835010,737510,2572520
2023,ssp126,Narrowbody,910179,969740,286083,2166002,406518,2572520
2023,ssp126,Widebody,35972,1017807,776920,1830699,741821,2572520
2023,ssp245,Narrowbody,920076,962003,288339,2170418,402102,2572520
2023,ssp245,Widebody,39138,1020007,780444,1839589,732931,2572520
2023,ssp370,Narrowbody,921656,959342,289112,2170110,402410,2572520
2023,ssp370,Widebody,41476,1015322,782586,1839384,733136,2572520
2023,ssp585,Narrowbody,917162,964197,287110,2168469,404051,2572520
2023,ssp585,Widebody,37853,1019795,778833,1836481,736039,2572520
2024,ssp126,Narrowbody,915755,970506,286337,2172598,406970,2579568
2024,ssp126,Widebody,37361,1019913,782420,1839694,739874,2579568
2024,ssp245,Narrowbody,917825,968735,287760,2174320,405248,2579568
2024,ssp245,Widebody,38016,1020781,783029,1841826,737742,2579568
2024,ssp370,Narrowbody,920459,965783,290419,2176661,402907,2579568
2024,ssp370,Widebody,38210,1023062,782398,1843670,735898,2579568
2024,ssp585,Narrowbody,922782,963185,289617,2175584,403984,2579568
2024,ssp585,Widebody,40053,1020073,783922,1844048,735520,2579568
2025,ssp126,Narrowbody,916073,963622,288473,2168168,404352,2572520
2025,ssp126,Widebody,39200,1016149,779946,1835295,737225,2572520
2025,ssp245,Narrowbody,919747,960741,287625,2168113,404407,2572520
2025,ssp245,Widebody,40597,1013846,782924,1837367,735153,2572520
2025,ssp370,Narrowbody,917469,965065,287182,2169716,402804,2572520
2025,ssp370,Widebody,38944,1017055,781659,1837658,734862,2572520
2025,ssp585,Narrowbody,918689,961151,288359,2168199,404321,2572520
2025,ssp585,Widebody,39508,1017817,779693,1837018,735502,2572520
2026,ssp126,Narrowbody,917356,963460,288350,2169166,403354,2572520
2026,ssp126,Widebody,39180,1018402,778731,1836313,736207,2572520
2026,ssp245,Narrowbody,918319,961749,289809,2169877,402643,2572520
2026,ssp245,Widebody,40218,1017342,778522,1836082,736438,2572520
2026,ssp370,Narrowbody,917488,962469,286758,2166715,405805,2572520
2026,ssp370,Widebody,39335,1016963,778762,1835060,737460,2572520
2026,ssp585,Narrowbody,918523,961880,287691,2168094,404426,2572520
2026,ssp585,Widebody,37930,1020388,780095,1838413,734107,2572520
2027,ssp126,Narrowbody,914375,966588,286444,2167407,405113,2572520
2027,ssp126,Widebody,35687,1019846,780246,1835779,736741,2572520
2027,ssp245,Narrowbody,920446,959478,289691,2169615,402905,2572520
2027,ssp245,Widebody,41736,1015589,780890,1838215,734305,2572520
2027,ssp370,Narrowbody,918244,960896,287729,2166869,405651,2572520
2027,ssp370,Widebody,40647,1012820,782023,1835490,737030,2572520
2027,ssp585,Narrowbody,920531,960610,288149,2169290,403230,2572520
2027,ssp585,Widebody,39837,1017374,781693,1838904,733616,2572520
2028,ssp126,Narrowbody,917283,968842,287635,2173760,405808,2579568
2028,ssp126,Widebody,37168,1021443,781830,1840441,739127,2579568
2028,ssp245,Narrowbody,921312,964387,288654,2174353,405215,2579568
2028,ssp245,Widebody,40871,1018146,783489,1842506,737062,2579568
2028,ssp370,Narrowbody,922137,963903,289397,2175437,404131,2579568
2028,ssp370,Widebody,39675,1019605,784418,1843698,735870,2579568
2028,ssp585,Narrowbody,920010,967370,288144,2175524,404044,2579568
2028,ssp585,Widebody,37660,1022988,782376,1843024,736544,2579568
2029,ssp126,Narrowbody,917789,962679,288241,2168709,403811,2572520
2029,ssp126,Widebody,38659,1014865,782259,1835783,736737,2572520
2029,ssp245,Narrowbody,910660,968180,287367,2166207,406313,2572520
2029,ssp245,Widebody,36201,1015696,779206,1831103,741417,2572520
2029,ssp370,Narrowbody,917063,963187,287649,2167899,404621,2572520
2029,ssp370,Widebody,37539,1017077,782008,1836624,735896,2572520
2029,ssp585,Narrowbody,916843,964566,286711,2168120,404400,2572520
2029,ssp585,Widebody,36963,1019563,780747,1837273,735247,2572520
2030,ssp126,Narrowbody,922013,958537,289283,2169833,402687,2572520
2030,ssp126,Widebody,42728,1014444,782017,1839189,733331,2572520
2030,ssp245,Narrowbody,913670,966712,287211,2167593,404927,2572520
2030,ssp245,Widebody,37965,1016880,779500,1834345,738175,2572520
2030,ssp370,Narrowbody,916774,965022,286214,2168010,404510,2572520
2030,ssp370,Widebody,37490,1019770,780229,1837489,735031,2572520
2030,ssp585,Narrowbody,911878,968124,286513,2166515,406005,2572520
2030,ssp585,Widebody,36476,1016624,780472,1833572,738948,2572520
2031,ssp126,Narrowbody,917324,964541,289093,2170958,401562,2572520
2031,ssp126,Widebody,38434,1018814,781588,1838836,733684,2572520
2031,ssp245,Narrowbody,916370,964601,287059,2168030,404490,2572520
2031,ssp245,Widebody,39240,1018156,778169,1835565,736955,2572520
2031,ssp370,Narrowbody,914984,964172,287512,2166668,405852,2572520
2031,ssp370,Widebody,38393,1016854,778204,1833451,739069,2572520
2031,ssp585,Narrowbody,920394,958077,287879,2166350,406170,2572520
2031,ssp585,Widebody,41062,1012686,783063,1836811,735709,2572520
2032,ssp126,Narrowbody,918473,966519,287463,2172455,407113,2579568
2032,ssp126,Widebody,39076,1017779,782944,1839799,739769,2579568
2032,ssp245,Narrowbody,917734,967064,289664,2174462,405106,2579568
2032,ssp245,Widebody,39212,1019714,781492,1840418,739150,2579568
2032,ssp370,Narrowbody,920020,966654,289379,2176053,403515,2579568
2032,ssp370,Widebody,38501,1021075,783384,1842960,736608,2579568
2032,ssp585,Narrowbody,918871,966662,287522,2173055,406513,2579568
2032,ssp585,Widebody,39865,1019197,781408,1840470,739098,2579568
2033,ssp126,Narrowbody,915938,965251,287413,2168602,403918,2572520
2033,ssp126,Widebody,37635,1018901,780925,1837461,735059,2572520
2033,ssp245,Narrowbody,912738,965917,287655,2166310,406210,2572520
2033,ssp245,Widebody,37280,1016943,779542,1833765,738755,2572520
2033,ssp370,Narrowbody,906941,971913,286319,2165173,407347,2572520
2033,ssp370,Widebody,34935,1016926,777245,1829106,743414,2572520
2033,ssp585,Narrowbody,916493,964412,287614,2168519,404001,2572520
2033,ssp585,Widebody,37821,1019433,779949,1837203,735317,2572520
2034,ssp126,Narrowbody,919124,962940,287315,2169379,403141,2572520
2034,ssp126,Widebody,38381,1017849,781852,1838082,734438,2572520
2034,ssp245,Narrowbody,913687,966340,287366,2167393,405127,2572520
2034,ssp245,Widebody,37334,1015481,781778,1834593,737927,2572520
2034,ssp370,Narrowbody,915897,964847,287433,2168177,404343,2572520
2034,ssp370,Widebody,38368,1016658,781245,1836271,736249,2572520
2034,ssp585,Narrowbody,912643,967292,287594,2167529,404991,2572520
2034,ssp585,Widebody,36237,1020661,777659,1834557,737963,2572520
2035,ssp126,Narrowbody,919233,960921,288356,2168510,404010,2572520
2035,ssp126,Widebody,39662,1015673,782012,1837347,735173,2572520
2035,ssp245,Narrowbody,915369,963817,287622,2166808,405712,2572520
2035,ssp245,Widebody,39886,1014983,778279,1833148,739372,2572520
2035,ssp370,Narrowbody,913906,965620,286439,2165965,406555,2572520
2035,ssp370,Widebody,37228,1016995,780330,1834553,737967,2572520
2035,ssp585,Narrowbody,910148,969172,286348,2165668,406852,2572520
2035,ssp585,Widebody,36827,1017126,777041,1830994,741526,2572520
2036,ssp126,Narrowbody,920133,963938,290322,2174393,405175,2579568
2036,ssp126,Widebody,40701,1018602,780320,1839623,739945,2579568
2036,ssp245,Narrowbody,923493,962549,289117,2175159,404409,2579568
2036,ssp245,Widebody,41799,1016941,785599,1844339,735229,2579568
2036,ssp370,Narrowbody,918462,967975,287271,2173708,405860,2579568
2036,ssp370,Widebody,38907,1019850,781869,1840626,738942,2579568
2036,ssp585,Narrowbody,919646,967006,287250,2173902,405666,2579568
2036,ssp585,Widebody,38401,1021413,781664,1841478,738090,2579568
2037,ssp126,Narrowbody,920369,960087,287774,2168230,404290,2572520
2037,ssp126,Widebody,41494,1015969,780366,1837829,734691,2572520
2037,ssp245,Narrowbody,914647,965049,286963,2166659,405861,2572520
2037,ssp245,Widebody,37689,1017474,779816,1834979,737541,2572520
2037,ssp370,Narrowbody,915388,965778,286497,2167663,404857,2572520
2037,ssp370,Widebody,36951,1019146,780016,1836113,736407,2572520
2037,ssp585,Narrowbody,914808,965871,287276,2167955,404565,2572520
2037,ssp585,Widebody,37323,1019904,779489,1836716,735804,2572520
2038,ssp126,Narrowbody,911249,968058,287426,2166733,405787,2572520
2038,ssp126,Widebody,37300,1017566,777280,1832146,740374,2572520
2038,ssp245,Narrowbody,915626,964196,288858,2168680,403840,2572520
2038,ssp245,Widebody,38161,1017658,780170,1835989,736531,2572520
2038,ssp370,Narrowbody,915443,965444,287317,2168204,404316,2572520
2038,ssp370,Widebody,36254,1020725,779923,1836902,735618,2572520
2038,ssp585,Narrowbody,911086,967149,286130,2164365,408155,2572520
2038,ssp585,Widebody,37658,1014726,777872,1830256,742264,2572520
2039,ssp126,Narrowbody,916377,963342,287127,2166846,405674,2572520
2039,ssp126,Widebody,39870,1014331,780884,1835085,737435,2572520
2039,ssp245,Narrowbody,913317,965199,287327,2165843,406677,2572520
2039,ssp245,Widebody,37021,1017939,777500,1832460,740060,2572520
2039,ssp370,Narrowbody,914049,965113,288156,2167318,405202,2572520
2039,ssp370,Widebody,37666,1015563,780753,1833982,738538,2572520
2039,ssp585,Narrowbody,920351,960252,287648,2168251,404269,2572520
2039,ssp585,Widebody,40166,1016404,782493,1839063,733457,2572520
2040,ssp126,Narrowbody,914470,969136,288095,2171701,407867,2579568
2040,ssp126,Widebody,38658,1018104,779081,1835843,743725,2579568
2040,ssp245,Narrowbody,920370,965601,288879,2174850,404718,2579568
2040,ssp245,Widebody,39490,1017348,785517,1842355,737213,2579568
2040,ssp370,Narrowbody,912751,970599,287134,2170484,409084,2579568
2040,ssp370,Widebody,37866,1016663,780262,1834791,744777,2579568
2040,ssp585,Narrowbody,917307,967251,287968,2172526,407042,2579568
2040,ssp585,Widebody,37691,1020705,781380,1839776,739792,2579568
2041,ssp126,Narrowbody,912066,967430,286854,2166350,406170,2572520
2041,ssp126,Widebody,36275,1017179,779016,1832470,740050,2572520
2041,ssp245,Narrowbody,918840,962115,288208,2169163,403357,2572520
2041,ssp245,Widebody,39627,1016597,781284,1837508,735012,2572520
2041,ssp370,Narrowbody,916980,963152,289268,2169400,403120,2572520
2041,ssp370,Widebody,38271,1017783,781287,1837341,735179,2572520
2041,ssp585,Narrowbody,909209,969692,287115,2166016,406504,2572520
2041,ssp585,Widebody,36041,1018673,776442,1831156,741364,2572520
2042,ssp126,Narrowbody,917242,962817,287953,2168012,404508,2572520
2042,ssp126,Widebody,39207,1016788,779678,1835673,736847,2572520
2042,ssp245,Narrowbody,918985,960492,288117,2167594,404926,2572520
2042,ssp245,Widebody,40185,1014348,782349,1836882,735638,2572520
2042,ssp370,Narrowbody,912185,966773,287758,2166716,405804,2572520
2042,ssp370,Widebody,37055,1017327,778345,1832727,739793,2572520
2042,ssp585,Narrowbody,910480,969311,285619,2165410,407110,2572520
2042,ssp585,Widebody,35099,1019627,776888,1831614,740906,2572520
2043,ssp126,Narrowbody,915510,964840,287740,2168090,404430,2572520
2043,ssp126,Widebody,38407,1017691,780197,1836295,736225,2572520
2043,ssp245,Narrowbody,917563,962308,287894,2167765,404755,2572520
2043,ssp245,Widebody,39967,1016860,779600,1836427,736093,2572520
2043,ssp370,Narrowbody,913982,965113,286766,2165861,406659,2572520
2043,ssp370,Widebody,36688,1017203,780555,1834446,738074,2572520
2043,ssp585,Narrowbody,914020,965683,285569,2165272,407248,2572520
2043,ssp585,Widebody,37051,1015715,781455,1834221,738299,2572520
2044,ssp126,Narrowbody,917733,967453,288799,2173985,405583,2579568
2044,ssp126,Widebody,38454,1020597,781036,1840087,739481,2579568
2044,ssp245,Narrowbody,918187,967241,288450,2173878,405690,2579568
2044,ssp245,Widebody,38180,1022196,779637,1840013,739555,2579568
2044,ssp370,Narrowbody,918797,966075,287742,2172614,406954,2579568
2044,ssp370,Widebody,38408,1018865,783157,1840430,739138,2579568
2044,ssp585,Narrowbody,914261,969592,287016,2170869,408699,2579568
2044,ssp585,Widebody,37385,1019107,780749,1837241,742327,2579568
2045,ssp126,Narrowbody,914305,965445,286589,2166339,406181,2572520
2045,ssp126,Widebody,38351,1014192,782027,1834570,737950,2572520
2045,ssp245,Narrowbody,915942,965416,287342,2168700,403820,2572520
2045,ssp245,Widebody,36825,1020056,779748,1836629,735891,2572520
2045,ssp370,Narrowbody,917824,962500,288307,2168631,403889,2572520
2045,ssp370,Widebody,38823,1017335,780754,1836912,735608,2572520
2045,ssp585,Narrowbody,914017,965874,285575,2165466,407054,2572520
2045,ssp585,Widebody,37208,1018858,778333,1834399,738121,2572520
2046,ssp126,Narrowbody,908989,969368,285460,2163817,408703,2572520
2046,ssp126,Widebody,37109,1014507,777856,1829472,743048,2572520
2046,ssp245,Narrowbody,911829,967602,287519,2166950,405570,2572520
2046,ssp245,Widebody,37914,1016377,777827,1832118,740402,2572520
2046,ssp370,Narrowbody,910399,967969,286596,2164964,407556,2572520
2046,ssp370,Widebody,36525,1017017,777063,1830605,741915,2572520
2046,ssp585,Narrowbody,918909,959788,287670,2166367,406153,2572520
2046,ssp585,Widebody,40341,1015126,779680,1835147,737373,2572520
2047,ssp126,Narrowbody,915496,965352,287840,2168688,403832,2572520
2047,ssp126,Widebody,36796,1017323,782345,1836464,736056,2572520
2047,ssp245,Narrowbody,911150,968279,285597,2165026,407494,2572520
2047,ssp245,Widebody,36714,1013777,780433,1830924,741596,2572520
2047,ssp370,Narrowbody,913291,965301,286642,2165234,407286,2572520
2047,ssp370,Widebody,38328,1013921,779983,1832232,740288,2572520
2047,ssp585,Narrowbody,911260,967024,287112,2165396,407124,2572520
2047,ssp585,Widebody,37805,1015895,776995,1830695,741825,2572520
2048,ssp126,Narrowbody,922835,961500,290002,2174337,405231,2579568
2048,ssp126,Widebody,42080,1016191,783681,1841952,737616,2579568
2048,ssp245,Narrowbody,918046,968885,287172,2174103,405465,2579568
2048,ssp245,Widebody,36892,1021374,783348,1841614,737954,2579568
2048,ssp370,Narrowbody,923026,961823,289120,2173969,405599,2579568
2048,ssp370,Widebody,41444,1017166,783791,1842401,737167,2579568
2048,ssp585,Narrowbody,912787,970751,287527,2171065,408503,2579568
2048,ssp585,Widebody,37523,1018538,779685,1835746,743822,2579568
2049,ssp126,Narrowbody,915397,963458,286933,2165788,406732,2572520
2049,ssp126,Widebody,39991,1014980,778535,1833506,739014,2572520
2049,ssp245,Narrowbody,914941,965524,287450,2167915,404605,2572520
2049,ssp245,Widebody,39082,1015357,780433,1834872,737648,2572520
2049,ssp370,Narrowbody,913318,965714,286942,2165974,406546,2572520
2049,ssp370,Widebody,39461,1016776,775744,1831981,740539,2572520
2049,ssp585,Narrowbody,903225,973989,283448,2160662,411858,2572520
2049,ssp585,Widebody,33864,1015414,774954,1824232,748288,2572520
2050,ssp126,Narrowbody,918914,962232,287137,2168283,404237,2572520
2050,ssp126,Widebody,39048,1014904,783523,1837475,735045,2572520
2050,ssp245,Narrowbody,914433,966452,287106,2167991,404529,2572520
2050,ssp245,Widebody,38113,1018794,778765,1835672,736848,2572520
2050,ssp370,Narrowbody,905664,972475,284899,2163038,409482,2572520
2050,ssp370,Widebody,35146,1017165,774519,1826830,745690,2572520
2050,ssp585,Narrowbody,912757,965385,286655,2164797,407723,2572520
2050,ssp585,Widebody,37160,1015000,778901,1831061,741459,2572520
2051,ssp126,Narrowbody,915244,965227,288238,2168709,403811,2572520
2051,ssp126,Widebody,38219,1016870,780563,1835652,736868,2572520
2051,ssp245,Narrowbody,915971,962294,286287,2164552,407968,2572520
2051,ssp245,Widebody,39233,1012380,782953,1834566,737954,2572520
2051,ssp370,Narrowbody,906462,970843,283910,2161215,411305,2572520
2051,ssp370,Widebody,36337,1013484,777013,1826834,745686,2572520
2051,ssp585,Narrowbody,909109,968708,286879,2164696,407824,2572520
2051,ssp585,Widebody,38112,1014784,776242,1829138,743382,2572520
2052,ssp126,Narrowbody,918001,966430,288460,2172891,406677,2579568
2052,ssp126,Widebody,37767,1019688,782680,1840135,739433,2579568
2052,ssp245,Narrowbody,916060,969616,286910,2172586,406982,2579568
2052,ssp245,Widebody,37448,1018667,782007,1838122,741446,2579568
2052,ssp370,Narrowbody,912238,970351,286338,2168927,410641,2579568
2052,ssp370,Widebody,37191,1017132,779253,1833576,745992,2579568
2052,ssp585,Narrowbody,914474,970600,286487,2171561,408007,2579568
2052,ssp585,Widebody,37663,1020703,778869,1837235,742333,2579568
2053,ssp126,Narrowbody,913585,966391,287328,2167304,405216,2572520
2053,ssp126,Widebody,37199,1015578,780663,1833440,739080,2572520
2053,ssp245,Narrowbody,908461,970824,285994,2165279,407241,2572520
2053,ssp245,Widebody,35797,1018816,776472,1831085,741435,2572520
2053,ssp370,Narrowbody,907071,970017,285798,2162886,409634,2572520
2053,ssp370,Widebody,35835,1011972,779586,1827393,745127,2572520
2053,ssp585,Narrowbody,910402,967842,285478,2163722,408798,2572520
2053,ssp585,Widebody,36422,1016345,777718,1830485,742035,2572520
2054,ssp126,Narrowbody,912073,967280,286618,2165971,406549,2572520
2054,ssp126,Widebody,36485,1017813,778024,1832322,740198,2572520
2054,ssp245,Narrowbody,912654,966619,286014,2165287,407233,2572520
2054,ssp245,Widebody,38176,1014493,778247,1830916,741604,2572520
2054,ssp370,Narrowbody,913278,964609,286133,2164020,408500,2572520
2054,ssp370,Widebody,38115,1014834,778912,1831861,740659,2572520
2054,ssp585,Narrowbody,911115,967213,285112,2163440,409080,2572520
2054,ssp585,Widebody,36519,1014982,780384,1831885,740635,2572520
2055,ssp126,Narrowbody,915003,965184,285828,2166015,406505,2572520
2055,ssp126,Widebody,37318,1017628,779882,1834828,737692,2572520
2055,ssp245,Narrowbody,917080,962422,286550,2166052,406468,2572520
2055,ssp245,Widebody,38540,1014672,782471,1835683,736837,2572520
2055,ssp370,Narrowbody,907855,970140,285983,2163978,408542,2572520
2055,ssp370,Widebody,34963,1016463,777402,1828828,743692,2572520
2055,ssp585,Narrowbody,910579,967762,285313,2163654,408866,2572520
2055,ssp585,Widebody,36385,1016615,777054,1830054,742466,2572520
2056,ssp126,Narrowbody,921120,964048,287661,2172829,406739,2579568
2056,ssp126,Widebody,38852,1017870,785042,1841764,737804,2579568
2056,ssp245,Narrowbody,916899,969098,287844,2173841,405727,2579568
2056,ssp245,Widebody,38170,1020885,781024,1840079,739489,2579568
2056,ssp370,Narrowbody,915020,970267,286174,2171461,408107,2579568
2056,ssp370,Widebody,37443,1019130,781321,1837894,741674,2579568
2056,ssp585,Narrowbody,908787,973799,286376,2168962,410606,2579568
2056,ssp585,Widebody,34262,1019352,778922,1832536,747032,2579568
2057,ssp126,Narrowbody,915346,964463,287784,2167593,404927,2572520
2057,ssp126,Widebody,39182,1017570,777912,1834664,737856,2572520
2057,ssp245,Narrowbody,916376,964421,286861,2167658,404862,2572520
2057,ssp245,Widebody,37896,1018938,779844,1836678,735842,2572520
2057,ssp370,Narrowbody,911860,966270,285991,2164121,408399,2572520
2057,ssp370,Widebody,37065,1015481,778598,1831144,741376,2572520
2057,ssp585,Narrowbody,908159,969319,284692,2162170,410350,2572520
2057,ssp585,Widebody,35548,1017178,776142,1828868,743652,2572520
2058,ssp126,Narrowbody,918790,961251,288221,2168262,404258,2572520
2058,ssp126,Widebody,38957,1019065,779936,1837958,734562,2572520
2058,ssp245,Narrowbody,911267,968414,285455,2165136,407384,2572520
2058,ssp245,Widebody,35324,1018786,777876,1831986,740534,2572520
2058,ssp370,Narrowbody,904782,973398,284521,2162701,409819,2572520
2058,ssp370,Widebody,33491,1017404,776461,1827356,745164,2572520
2058,ssp585,Narrowbody,911097,966181,287410,2164688,407832,2572520
2058,ssp585,Widebody,38113,1014922,777502,1830537,741983,2572520
2059,ssp126,Narrowbody,913900,966501,287309,2167710,404810,2572520
2059,ssp126,Widebody,36226,1019180,779503,1834909,737611,2572520
2059,ssp245,Narrowbody,909496,969401,285579,2164476,408044,2572520
2059,ssp245,Widebody,36789,1014702,777982,1829473,743047,2572520
2059,ssp370,Narrowbody,906799,970031,283814,2160644,411876,2572520
2059,ssp370,Widebody,36547,1012835,776946,1826328,746192,2572520
2059,ssp585,Narrowbody,906658,971803,283917,2162378,410142,2572520
2059,ssp585,Widebody,34413,1016550,777387,1828350,744170,2572520
2060,ssp126,Narrowbody,914365,970948,286547,2171860,407708,2579568
2060,ssp126,Widebody,36900,1019254,780889,1837043,742525,2579568
2060,ssp245,Narrowbody,913671,970596,287621,2171888,407680,2579568
2060,ssp245,Widebody,35732,1020410,780955,1837097,742471,2579568
2060,ssp370,Narrowbody,912149,971069,286061,2169279,410289,2579568
2060,ssp370,Widebody,36885,1019790,777879,1834554,745014,2579568
2060,ssp585,Narrowbody,904826,977144,283784,2165754,413814,2579568
2060,ssp585,Widebody,32441,1019562,776541,1828544,751024,2579568
2061,ssp126,Narrowbody,914505,965181,287798,2167484,405036,2572520
2061,ssp126,Widebody,37684,1016551,781138,1835373,737147,2572520
2061,ssp245,Narrowbody,916081,962571,287854,2166506,406014,2572520
2061,ssp245,Widebody,39628,1014892,779702,1834222,738298,2572520
2061,ssp370,Narrowbody,907584,969220,285968,2162772,409748,2572520
2061,ssp370,Widebody,35273,1016204,776570,1828047,744473,2572520
2061,ssp585,Narrowbody,906360,970203,283985,2160548,411972,2572520
2061,ssp585,Widebody,34343,1015127,777716,1827186,745334,2572520
2062,ssp126,Narrowbody,913763,967207,287134,2168104,404416,2572520
2062,ssp126,Widebody,37755,1017802,778873,1834430,738090,2572520
2062,ssp245,Narrowbody,912770,966813,286645,2166228,406292,2572520
2062,ssp245,Widebody,36336,1017121,780772,1834229,738291,2572520
2062,ssp370,Narrowbody,909784,969582,284910,2164276,408244,2572520
2062,ssp370,Widebody,35266,1016695,779713,1831674,740846,2572520
2062,ssp585,Narrowbody,910079,966097,286249,2162425,410095,2572520
2062,ssp585,Widebody,38949,1009473,778235,1826657,745863,2572520
2063,ssp126,Narrowbody,917653,962218,288530,2168401,404119,2572520
2063,ssp126,Widebody,38663,1016633,782236,1837532,734988,2572520
2063,ssp245,Narrowbody,911928,966878,285659,2164465,408055,2572520
2063,ssp245,Widebody,37716,1014234,778908,1830858,741662,2572520
2063,ssp370,Narrowbody,910358,966408,285818,2162584,409936,2572520
2063,ssp370,Widebody,36474,1012753,780130,1829357,743163,2572520
2063,ssp585,Narrowbody,903785,971804,285904,2161493,411027,2572520
2063,ssp585,Widebody,35188,1014644,774129,1823961,748559,2572520
2064,ssp126,Narrowbody,915536,970318,287386,2173240,406328,2579568
2064,ssp126,Widebody,36992,1020776,782096,1839864,739704,2579568
2064,ssp245,Narrowbody,911540,972108,286437,2170085,409483,2579568
2064,ssp245,Widebody,36394,1017788,779801,1833983,745585,2579568
2064,ssp370,Narrowbody,912812,967848,288312,2168972,410596,2579568
2064,ssp370,Widebody,37775,1013040,783450,1834265,745303,2579568
2064,ssp585,Narrowbody,906722,974429,286388,2167539,412029,2579568
2064,ssp585,Widebody,34681,1016836,779310,1830827,748741,2579568
2065,ssp126,Narrowbody,914406,966497,287131,2168034,404486,2572520
2065,ssp126,Widebody,37661,1016469,781307,1835437,737083,2572520
2065,ssp245,Narrowbody,906734,972447,285798,2164979,407541,2572520
2065,ssp245,Widebody,35596,1016249,777006,1828851,743669,2572520
2065,ssp370,Narrowbody,905069,972788,284175,2162032,410488,2572520
2065,ssp370,Widebody,34342,1017270,774568,1826180,746340,2572520
2065,ssp585,Narrowbody,899196,974069,283496,2156761,415759,2572520
2065,ssp585,Widebody,33407,1011314,775052,1819773,752747,2572520
2066,ssp126,Narrowbody,910904,969430,285324,2165658,406862,2572520
2066,ssp126,Widebody,35516,1019820,777455,1832791,739729,2572520
2066,ssp245,Narrowbody,908017,968246,285392,2161655,410865,2572520
2066,ssp245,Widebody,37366,1010620,778879,1826865,745655,2572520
2066,ssp370,Narrowbody,908553,968009,285207,2161769,410751,2572520
2066,ssp370,Widebody,36525,1013596,776112,1826233,746287,2572520
2066,ssp585,Narrowbody,906493,969880,284513,2160886,411634,2572520
2066,ssp585,Widebody,34833,1015287,776716,1826836,745684,2572520
2067,ssp126,Narrowbody,912896,967069,285787,2165752,406768,2572520
2067,ssp126,Widebody,37332,1014582,780968,1832882,739638,2572520
2067,ssp245,Narrowbody,910471,967616,286906,2164993,407527,2572520
2067,ssp245,Widebody,36317,1016270,777977,1830564,741956,2572520
2067,ssp370,Narrowbody,901379,975065,283000,2159444,413076,2572520
2067,ssp370,Widebody,34117,1014602,773325,1822044,750476,2572520
2067,ssp585,Narrowbody,903082,973379,283884,2160345,412175,2572520
2067,ssp585,Widebody,33899,1015689,774826,1824414,748106,2572520
2068,ssp126,Narrowbody,918520,966724,287466,2172710,406858,2579568
2068,ssp126,Widebody,38877,1019291,782085,1840253,739315,2579568
2068,ssp245,Narrowbody,915920,969238,287433,2172591,406977,2579568
2068,ssp245,Widebody,38480,1018271,781495,1838246,741322,2579568
2068,ssp370,Narrowbody,906610,974573,283719,2164902,414666,2579568
2068,ssp370,Widebody,35134,1016115,776523,1827772,751796,2579568
2068,ssp585,Narrowbody,905616,975869,286076,2167561,412007,2579568
2068,ssp585,Widebody,34872,1017576,777351,1829799,749769,2579568
2069,ssp126,Narrowbody,911947,969371,285749,2167067,405453,2572520
2069,ssp126,Widebody,35791,1019054,778797,1833642,738878,2572520
2069,ssp245,Narrowbody,913692,964932,286969,2165593,406927,2572520
2069,ssp245,Widebody,38083,1015787,778608,1832478,740042,2572520
2069,ssp370,Narrowbody,908817,967799,285421,2162037,410483,2572520
2069,ssp370,Widebody,36658,1013281,777751,1827690,744830,2572520
2069,ssp585,Narrowbody,906288,970258,284317,2160863,411657,2572520
2069,ssp585,Widebody,35458,1013040,776936,1825434,747086,2572520
2070,ssp126,Narrowbody,911984,969986,284889,2166859,405661,2572520
2070,ssp126,Widebody,36040,1020394,777213,1833647,738873,2572520
2070,ssp245,Narrowbody,914463,964093,286606,2165162,407358,2572520
2070,ssp245,Widebody,38614,1013659,780056,1832329,740191,2572520
2070,ssp370,Narrowbody,907016,969336,284739,2161091,411429,2572520
2070,ssp370,Widebody,36891,1012302,776733,1825926,746594,2572520
2070,ssp585,Narrowbody,894491,979815,282685,2156991,415529,2572520
2070,ssp585,Widebody,31627,1013098,772172,1816897,755623,2572520
2071,ssp126,Narrowbody,918237,962174,288927,2169338,403182,2572520
2071,ssp126,Widebody,38968,1016778,781305,1837051,735469,2572520
2071,ssp245,Narrowbody,907252,970212,284737,2162201,410319,2572520
2071,ssp245,Widebody,35949,1013344,777727,1827020,745500,2572520
2071,ssp370,Narrowbody,902023,973973,283967,2159963,412557,2572520
2071,ssp370,Widebody,33451,1015429,774423,1823303,749217,2572520
2071,ssp585,Narrowbody,904462,970200,283913,2158575,413945,2572520
2071,ssp585,Widebody,35447,1010837,776116,1822400,750120,2572520
2072,ssp126,Narrowbody,920054,965355,288719,2174128,405440,2579568
2072,ssp126,Widebody,38208,1020475,783324,1842007,737561,2579568
2072,ssp245,Narrowbody,911419,973011,285600,2170030,409538,2579568
2072,ssp245,Widebody,35041,1020980,779025,1835046,744522,2579568
2072,ssp370,Narrowbody,904696,976464,285092,2166252,413316,2579568
2072,ssp370,Widebody,34215,1017948,776782,1828945,750623,2579568
2072,ssp585,Narrowbody,906257,974016,285091,2165364,414204,2579568
2072,ssp585,Widebody,36082,1013684,778919,1828685,750883,2579568
2073,ssp126,Narrowbody,911436,968187,286191,2165814,406706,2572520
2073,ssp126,Widebody,36580,1017642,778990,1833212,739308,2572520
2073,ssp245,Narrowbody,909876,970670,285108,2165654,406866,2572520
2073,ssp245,Widebody,35880,1017349,779488,1832717,739803,2572520
2073,ssp370,Narrowbody,900581,975365,283976,2159922,412598,2572520
2073,ssp370,Widebody,32359,1016270,773749,1822378,750142,2572520
2073,ssp585,Narrowbody,897772,976299,282521,2156592,415928,2572520
2073,ssp585,Widebody,33742,1012670,771602,1818014,754506,2572520
2074,ssp126,Narrowbody,916641,964047,287692,2168380,404140,2572520
2074,ssp126,Widebody,38605,1016517,781692,1836814,735706,2572520
2074,ssp245,Narrowbody,910760,968189,286400,2165349,407171,2572520
2074,ssp245,Widebody,35551,1016849,779982,1832382,740138,2572520
2074,ssp370,Narrowbody,903082,972268,283941,2159291,413229,2572520
2074,ssp370,Widebody,34912,1012543,776089,1823544,748976,2572520
2074,ssp585,Narrowbody,905973,968244,284720,2158937,413583,2572520
2074,ssp585,Widebody,37347,1009216,776720,1823283,749237,2572520
2075,ssp126,Narrowbody,920230,960103,288043,2168376,404144,2572520
2075,ssp126,Widebody,40313,1015724,782551,1838588,733932,2572520
2075,ssp245,Narrowbody,911505,967257,284995,2163757,408763,2572520
2075,ssp245,Widebody,36887,1016227,778578,1831692,740828,2572520
2075,ssp370,Narrowbody,903573,971410,284747,2159730,412790,2572520
2075,ssp370,Widebody,34732,1014487,773293,1822512,750008,2572520
2075,ssp585,Narrowbody,899175,974470,284079,2157724,414796,2572520
2075,ssp585,Widebody,34584,1011649,772638,1818871,753649,2572520
2076,ssp126,Narrowbody,916694,967973,287871,2172538,407030,2579568
2076,ssp126,Widebody,38468,1019239,780714,1838421,741147,2579568
2076,ssp245,Narrowbody,904997,977378,285783,2168158,411410,2579568
2076,ssp245,Widebody,33753,1018620,777123,1829496,750072,2579568
2076,ssp370,Narrowbody,905784,975874,284357,2166015,413553,2579568
2076,ssp370,Widebody,34086,1017794,777838,1829718,749850,2579568
2076,ssp585,Narrowbody,905234,973844,285566,2164644,414924,2579568
2076,ssp585,Widebody,35670,1013821,776999,1826490,753078,2579568
2077,ssp126,Narrowbody,917893,961955,288069,2167917,404603,2572520
2077,ssp126,Widebody,39927,1013664,783367,1836958,735562,2572520
2077,ssp245,Narrowbody,908843,969370,284423,2162636,409884,2572520
2077,ssp245,Widebody,35062,1018325,775382,1828769,743751,2572520
2077,ssp370,Narrowbody,907780,967941,286218,2161939,410581,2572520
2077,ssp370,Widebody,36306,1015503,775322,1827131,745389,2572520
2077,ssp585,Narrowbody,903549,971355,284274,2159178,413342,2572520
2077,ssp585,Widebody,35819,1009976,776174,1821969,750551,2572520
2078,ssp126,Narrowbody,916967,963806,287879,2168652,403868,2572520
2078,ssp126,Widebody,38727,1016048,782532,1837307,735213,2572520
2078,ssp245,Narrowbody,910890,968486,285661,2165037,407483,2572520
2078,ssp245,Widebody,37133,1017005,777274,1831412,741108,2572520
2078,ssp370,Narrowbody,902096,972468,283807,2158371,414149,2572520
2078,ssp370,Widebody,34082,1013633,774068,1821783,750737,2572520
2078,ssp585,Narrowbody,901786,971595,284232,2157613,414907,2572520
2078,ssp585,Widebody,35631,1011124,774221,1820976,751544,2572520
2079,ssp126,Narrowbody,915345,965172,286794,2167311,405209,2572520
2079,ssp126,Widebody,37476,1018953,779598,1836027,736493,2572520
2079,ssp245,Narrowbody,911450,966213,286837,2164500,408020,2572520
2079,ssp245,Widebody,36781,1015137,778503,1830421,742099,2572520
2079,ssp370,Narrowbody,899080,975621,283729,2158430,414090,2572520
2079,ssp370,Widebody,32717,1015169,773009,1820895,751625,2572520
2079,ssp585,Narrowbody,898896,974501,284406,2157803,414717,2572520
2079,ssp585,Widebody,34238,1012575,772128,1818941,753579,2572520
2080,ssp126,Narrowbody,921798,965300,290334,2177432,402136,2579568
2080,ssp126,Widebody,38934,1023258,783002,1845194,734374,2579568
2080,ssp245,Narrowbody,911863,971310,286584,2169757,409811,2579568
2080,ssp245,Widebody,38082,1016517,779241,1833840,745728,2579568
2080,ssp370,Narrowbody,908662,972723,285457,2166842,412726,2579568
2080,ssp370,Widebody,35028,1018059,778085,1831172,748396,2579568
2080,ssp585,Narrowbody,897819,980774,283598,2162191,417377,2579568
2080,ssp585,Widebody,32638,1014909,774200,1821747,757821,2579568
2081,ssp126,Narrowbody,915145,966029,286793,2167967,404553,2572520
2081,ssp126,Widebody,37424,1019232,779386,1836042,736478,2572520
2081,ssp245,Narrowbody,907894,970687,284688,2163269,409251,2572520
2081,ssp245,Widebody,35735,1013990,779165,1828890,743630,2572520
2081,ssp370,Narrowbody,903035,972417,283814,2159266,413254,2572520
2081,ssp370,Widebody,34983,1014735,773185,1822903,749617,2572520
2081,ssp585,Narrowbody,896328,975606,282624,2154558,417962,2572520
2081,ssp585,Widebody,33491,1009911,772907,1816309,756211,2572520
2082,ssp126,Narrowbody,912667,967524,286792,2166983,405537,2572520
2082,ssp126,Widebody,37552,1018309,776855,1832716,739804,2572520
2082,ssp245,Narrowbody,910632,967600,285549,2163781,408739,2572520
2082,ssp245,Widebody,37230,1015150,778951,1831331,741189,2572520
2082,ssp370,Narrowbody,903758,972253,285219,2161230,411290,2572520
2082,ssp370,Widebody,32925,1015014,778037,1825976,746544,2572520
2082,ssp585,Narrowbody,897840,975372,284025,2157237,415283,2572520
2082,ssp585,Widebody,33357,1012002,773983,1819342,753178,2572520
2083,ssp126,Narrowbody,920653,959202,288561,2168416,404104,2572520
2083,ssp126,Widebody,42085,1013678,780809,1836572,735948,2572520
2083,ssp245,Narrowbody,914381,963842,286433,2164656,407864,2572520
2083,ssp245,Widebody,39255,1013952,778676,1831883,740637,2572520
2083,ssp370,Narrowbody,903287,972165,284554,2160006,412514,2572520
2083,ssp370,Widebody,33663,1013180,777865,1824708,747812,2572520
2083,ssp585,Narrowbody,897550,973607,281567,2152724,419796,2572520
2083,ssp585,Widebody,34218,1006543,775386,1816147,756373,2572520
2084,ssp126,Narrowbody,916311,971042,286640,2173993,405575,2579568
2084,ssp126,Widebody,36370,1022141,782981,1841492,738076,2579568
2084,ssp245,Narrowbody,914031,969821,287422,2171274,408294,2579568
2084,ssp245,Widebody,38281,1018086,779081,1835448,744120,2579568
2084,ssp370,Narrowbody,901769,977097,284819,2163685,415883,2579568
2084,ssp370,Widebody,33540,1016093,775059,1824692,754876,2579568
2084,ssp585,Narrowbody,902432,975357,283928,2161717,417851,2579568
2084,ssp585,Widebody,34068,1014741,775285,1824094,755474,2579568
2085,ssp126,Narrowbody,912698,967636,286601,2166935,405585,2572520
2085,ssp126,Widebody,36031,1019142,778502,1833675,738845,2572520
2085,ssp245,Narrowbody,904650,971655,284832,2161137,411383,2572520
2085,ssp245,Widebody,34960,1014113,775797,1824870,747650,2572520
2085,ssp370,Narrowbody,903983,971559,283877,2159419,413101,2572520
2085,ssp370,Widebody,35755,1012642,775200,1823597,748923,2572520
2085,ssp585,Narrowbody,898610,973707,282655,2154972,417548,2572520
2085,ssp585,Widebody,35319,1007911,773873,1817103,755417,2572520
2086,ssp126,Narrowbody,913722,966720,286576,2167018,405502,2572520
2086,ssp126,Widebody,36426,1018849,778826,1834101,738419,2572520
2086,ssp245,Narrowbody,910461,968020,286057,2164538,407982,2572520
2086,ssp245,Widebody,37475,1014798,777695,1829968,742552,2572520
2086,ssp370,Narrowbody,900968,974096,284142,2159206,413314,2572520
2086,ssp370,Widebody,33191,1014817,774030,1822038,750482,2572520
2086,ssp585,Narrowbody,900140,971649,282984,2154773,417747,2572520
2086,ssp585,Widebody,36686,1006637,774472,1817795,754725,2572520
2087,ssp126,Narrowbody,915708,965579,287086,2168373,404147,2572520
2087,ssp126,Widebody,37585,1018109,780935,1836629,735891,2572520
2087,ssp245,Narrowbody,904288,972216,285240,2161744,410776,2572520
2087,ssp245,Widebody,34630,1016169,775573,1826372,746148,2572520
2087,ssp370,Narrowbody,903627,971208,285219,2160054,412466,2572520
2087,ssp370,Widebody,33851,1014926,775065,1823842,748678,2572520
2087,ssp585,Narrowbody,895015,976015,282782,2153812,418708,2572520
2087,ssp585,Widebody,32891,1010182,770861,1813934,758586,2572520
2088,ssp126,Narrowbody,918431,966923,288473,2173827,405741,2579568
2088,ssp126,Widebody,38454,1020877,781981,1841312,738256,2579568
2088,ssp245,Narrowbody,909930,972850,286261,2169041,410527,2579568
2088,ssp245,Widebody,35731,1019231,777070,1832032,747536,2579568
2088,ssp370,Narrowbody,898599,980323,283991,2162913,416655,2579568
2088,ssp370,Widebody,32036,1016848,773935,1822819,756749,2579568
2088,ssp585,Narrowbody,899907,976821,282127,2158855,420713,2579568
2088,ssp585,Widebody,33288,1012662,774531,1820481,759087,2579568
2089,ssp126,Narrowbody,912941,965785,287569,2166295,406225,2572520
2089,ssp126,Widebody,37488,1016477,778564,1832529,739991,2572520
2089,ssp245,Narrowbody,907166,971041,285667,2163874,408646,2572520
2089,ssp245,Widebody,35542,1014970,777642,1828154,744366,2572520
2089,ssp370,Narrowbody,899941,973689,283214,2156844,415676,2572520
2089,ssp370,Widebody,34624,1008581,775616,1818821,753699,2572520
2089,ssp585,Narrowbody,890091,979913,282645,2152649,419871,2572520
2089,ssp585,Widebody,31261,1009811,769662,1810734,761786,2572520
2090,ssp126,Narrowbody,908667,970653,286518,2165838,406682,2572520
2090,ssp126,Widebody,34744,1020935,775441,1831120,741400,2572520
2090,ssp245,Narrowbody,909910,968255,285416,2163581,408939,2572520
2090,ssp245,Widebody,37496,1013628,778519,1829643,742877,2572520
2090,ssp370,Narrowbody,901312,973794,282964,2158070,414450,2572520
2090,ssp370,Widebody,34107,1013392,774045,1821544,750976,2572520
2090,ssp585,Narrowbody,893890,978102,282094,2154086,418434,2572520
2090,ssp585,Widebody,31831,1010059,773136,1815026,757494,2572520
2091,ssp126,Narrowbody,915848,966151,287428,2169427,403093,2572520
2091,ssp126,Widebody,38204,1019674,779963,1837841,734679,2572520
2091,ssp245,Narrowbody,908011,968433,286857,2163301,409219,2572520
2091,ssp245,Widebody,35434,1015627,776875,1827936,744584,2572520
2091,ssp370,Narrowbody,900315,971395,283844,2155554,416966,2572520
2091,ssp370,Widebody,35534,1010240,772529,1818303,754217,2572520
2091,ssp585,Narrowbody,889760,979129,282097,2150986,421534,2572520
2091,ssp585,Widebody,32875,1006993,769358,1809226,763294,2572520
2092,ssp126,Narrowbody,922445,965138,287855,2175438,404130,2579568
2092,ssp126,Widebody,38671,1023147,782359,1844177,735391,2579568
2092,ssp245,Narrowbody,910376,972952,286950,2170278,409290,2579568
2092,ssp245,Widebody,35908,1020316,776907,1833131,746437,2579568
2092,ssp370,Narrowbody,902245,976759,284248,2163252,416316,2579568
2092,ssp370,Widebody,34804,1015585,773563,1823952,755616,2579568
2092,ssp585,Narrowbody,898254,976977,282874,2158105,421463,2579568
2092,ssp585,Widebody,34996,1008385,775056,1818437,761131,2579568
2093,ssp126,Narrowbody,915031,964853,288280,2168164,404356,2572520
2093,ssp126,Widebody,37916,1018275,778966,1835157,737363,2572520
2093,ssp245,Narrowbody,904717,972438,284826,2161981,410539,2572520
2093,ssp245,Widebody,33625,1017892,774764,1826281,746239,2572520
2093,ssp370,Narrowbody,893918,978945,282781,2155644,416876,2572520
2093,ssp370,Widebody,32307,1013232,770500,1816039,756481,2572520
2093,ssp585,Narrowbody,890190,979231,282304,2151725,420795,2572520
2093,ssp585,Widebody,32472,1008885,768577,1809934,762586,2572520
2094,ssp126,Narrowbody,908506,969426,285722,2163654,408866,2572520
2094,ssp126,Widebody,36070,1016184,776873,1829127,743393,2572520
2094,ssp245,Narrowbody,908941,968633,285672,2163246,409274,2572520
2094,ssp245,Widebody,36815,1013398,778396,1828609,743911,2572520
2094,ssp370,Narrowbody,895097,976236,282849,2154182,418338,2572520
2094,ssp370,Widebody,33536,1008823,772977,1815336,757184,2572520
2094,ssp585,Narrowbody,884796,985499,280299,2150594,421926,2572520
2094,ssp585,Widebody,29519,1010954,766993,1807466,765054,2572520
2095,ssp126,Narrowbody,912442,966114,286371,2164927,407593,2572520
2095,ssp126,Widebody,37958,1013314,779502,1830774,741746,2572520
2095,ssp245,Narrowbody,907536,970417,285799,2163752,408768,2572520
2095,ssp245,Widebody,35961,1014597,778570,1829128,743392,2572520
2095,ssp370,Narrowbody,894095,979792,281176,2155063,417457,2572520
2095,ssp370,Widebody,30990,1012781,771857,1815628,756892,2572520
2095,ssp585,Narrowbody,887211,983081,280462,2150754,421766,2572520
2095,ssp585,Widebody,29058,1011166,769771,1809995,762525,2572520
2096,ssp126,Narrowbody,917539,967644,288585,2173768,405800,2579568
2096,ssp126,Widebody,38849,1017170,783677,1839696,739872,2579568
2096,ssp245,Narrowbody,913187,969435,285205,2167827,411741,2579568
2096,ssp245,Widebody,38673,1016383,779194,1834250,745318,2579568
2096,ssp370,Narrowbody,897159,981108,282433,2160700,418868,2579568
2096,ssp370,Widebody,31734,1015939,774039,1821712,757856,2579568
2096,ssp585,Narrowbody,890761,983793,281532,2156086,423482,2579568
2096,ssp585,Widebody,30672,1011823,772239,1814734,764834,2579568
2097,ssp126,Narrowbody,916636,963703,288774,2169113,403407,2572520
2097,ssp126,Widebody,38926,1017103,780807,1836836,735684,2572520
2097,ssp245,Narrowbody,904519,973857,284069,2162445,410075,2572520
2097,ssp245,Widebody,34435,1016070,776835,1827340,745180,2572520
2097,ssp370,Narrowbody,898859,974993,282824,2156676,415844,2572520
2097,ssp370,Widebody,32866,1014172,772169,1819207,753313,2572520
2097,ssp585,Narrowbody,888210,981210,281958,2151378,421142,2572520
2097,ssp585,Widebody,30533,1009218,770366,1810117,762403,2572520
2098,ssp126,Narrowbody,919602,961401,287930,2168933,403587,2572520
2098,ssp126,Widebody,40300,1016600,780143,1837043,735477,2572520
2098,ssp245,Narrowbody,911975,965501,287046,2164522,407998,2572520
2098,ssp245,Widebody,36513,1015213,780082,1831808,740712,2572520
2098,ssp370,Narrowbody,895769,975779,282135,2153683,418837,2572520
2098,ssp370,Widebody,31939,1009706,774927,1816572,755948,2572520
2098,ssp585,Narrowbody,885426,983012,279560,2147998,424522,2572520
2098,ssp585,Widebody,28230,1007761,771390,1807381,765139,2572520
2099,ssp126,Narrowbody,916122,964057,288793,2168972,403548,2572520
2099,ssp126,Widebody,39276,1017119,779673,1836068,736452,2572520
2099,ssp245,Narrowbody,911400,968024,285888,2165312,407208,2572520
2099,ssp245,Widebody,37666,1015347,778011,1831024,741496,2572520
2099,ssp370,Narrowbody,899477,973095,282638,2155210,417310,2572520
2099,ssp370,Widebody,34654,1008240,774921,1817815,754705,2572520
2099,ssp585,Narrowbody,886667,981814,279519,2148000,424520,2572520
2099,ssp585,Widebody,30124,1008294,768387,1806805,765715,2572520
2100,ssp126,Narrowbody,915619,964125,287246,2166990,405530,2572520
2100,ssp126,Widebody,37327,1018964,778718,1835009,737511,2572520
2100,ssp245,Narrowbody,906986,970316,285579,2162881,409639,2572520
2100,ssp245,Widebody,36003,1018569,772498,1827070,745450,2572520
2100,ssp370,Narrowbody,894820,975987,283681,2154488,418032,2572520
2100,ssp370,Widebody,32977,1009051,772680,1814708,757812,2572520
2100,ssp585,Narrowbody,886401,983170,279876,2149447,423073,2572520
2100,ssp585,Widebody,32775,1007345,766459,1806579,765941,2572520
